date,today_confirm,today_suspect,today_heal,today_dead,today_severe,today_storeConfirm,today_input,total_confirm,total_suspect,total_heal,total_dead,total_severe,total_input
2020-02-08,11,0.0,0,0,,,,11,0,0,0,0,0
2020-02-15,1,0.0,11,1,,,0.0,12,0,11,1,0,0
2020-02-25,2,0.0,0,0,,,0.0,14,0,11,1,0,0
2020-02-26,4,0.0,0,1,,,0.0,18,0,11,2,0,0
2020-02-27,20,0.0,0,0,,,0.0,38,0,11,2,0,0
2020-02-28,19,0.0,0,0,,,0.0,57,0,11,2,0,0
2020-02-29,43,0.0,1,0,,,0.0,100,0,12,2,0,0
2020-03-01,30,0.0,0,0,,,0.0,130,0,12,2,0,0
2020-03-02,61,0.0,0,1,,,0.0,191,0,12,3,0,0
2020-03-03,21,0.0,0,1,0.0,,0.0,212,0,12,4,0,0
2020-03-04,73,0.0,0,0,0.0,,0.0,285,0,12,4,0,0
2020-03-05,138,0.0,0,3,0.0,,0.0,423,0,12,7,0,0
2020-03-06,190,0.0,0,2,0.0,,0.0,613,0,12,9,0,0
2020-03-07,336,0.0,0,7,0.0,,0.0,949,0,12,16,0,0
2020-03-08,177,0.0,0,0,0.0,,0.0,1126,0,12,16,0,0
2020-03-09,286,0.0,0,5,0.0,,0.0,1412,0,12,21,0,0
2020-03-10,372,0.0,0,12,0.0,,0.0,1784,0,12,33,0,0
2020-03-11,497,0.0,0,15,0.0,,0.0,2281,0,12,48,0,0
2020-03-12,595,0.0,0,13,0.0,,0.0,2876,0,12,61,0,0
2020-03-13,785,0.0,0,18,0.0,,0.0,3661,0,12,79,0,0
2020-03-14,839,0.0,21,12,0.0,,0.0,4500,0,33,91,0,0
2020-03-15,923,0.0,0,36,0.0,,0.0,5423,0,33,127,0,0
2020-03-16,1210,0.0,0,21,0.0,,0.0,6633,0,33,148,0,0
2020-03-17,1097,0.0,569,27,0.0,,0.0,7730,0,602,175,0,0
2020-03-18,1404,0.0,0,89,0.0,,0.0,9134,0,602,264,0,0
2020-03-19,1861,0.0,0,108,0.0,,0.0,10995,0,602,372,0,0
2020-03-20,1617,0.0,985,78,0.0,,0.0,12612,0,1587,450,0,0
2020-03-21,1847,0.0,0,112,0.0,,0.0,14459,0,1587,562,0,0
2020-03-22,1559,0.0,0,112,0.0,,0.0,16018,0,1587,674,0,0
2020-03-23,4105,0.0,0,186,0.0,,0.0,20123,0,1587,860,0,0
2020-03-24,2177,0.0,1694,240,0.0,,0.0,22300,0,3281,1100,0,0
2020-03-25,2933,0.0,619,231,0.0,,0.0,25233,0,3900,1331,0,0
2020-03-26,3922,0.0,1048,365,0.0,,0.0,29155,0,4948,1696,0,0
2020-03-27,4259,0.0,752,299,0.0,,0.0,33414,0,5700,1995,0,0
2020-03-28,4691,0.0,24,319,0.0,,0.0,38105,0,5724,2314,0,0
2020-03-29,2069,0.0,1502,297,0.0,,0.0,40174,0,7226,2611,0,0
2020-03-30,4376,0.0,738,413,0.0,,0.0,44550,0,7964,3024,0,0
2020-03-31,7578,0.0,1480,499,0.0,,0.0,52128,0,9444,3523,0,0
2020-04-01,5689,0.0,1491,509,0.0,,0.0,57817,0,10935,4032,0,0
2020-04-02,1288,0.0,1613,1366,0.0,,0.0,59105,0,12548,5398,0,0
2020-04-03,5233,0.0,1460,1109,0.0,,0.0,64338,0,14008,6507,0,0
2020-04-04,18693,0.0,130,14,0.0,,0.0,83031,0,14138,6521,0,0
2020-04-05,7832,,1436,1053,,,0.0,90863,0,15574,7574,0,0
2020-04-06,2917,,780,519,,,0.0,93780,0,16354,8093,0,0
2020-04-07,5204,,1075,833,,,0.0,98984,0,17429,8926,0,0
2020-04-08,11086,,2094,1417,,,0.0,110070,0,19523,10343,0,0
2020-04-09,2880,,1731,526,,,0.0,112950,0,21254,10869,0,0
2020-04-10,5840,,2215,1359,,,0.0,118790,0,23469,12228,0,0
2020-04-11,7141,,1726,987,,,0.0,125931,0,25195,13215,0,0
2020-04-12,4799,,1479,636,,,0.0,130730,0,26674,13851,0,0
2020-04-13,2942,,795,561,,,0.0,133672,0,27469,14412,0,0
2020-04-14,4215,0.0,542,574,0.0,,0.0,137887,0,28011,14986,0,0
2020-04-15,5416,0.0,1112,743,0.0,,0.0,143303,0,29123,15729,0,0
2020-04-16,3788,0.0,4204,2212,0.0,,0.0,147091,0,33327,17941,0,0
2020-04-17,878,0.0,1093,740,0.0,,0.0,147969,0,34420,18681,0,0
2020-04-18,3824,0.0,1563,642,0.0,,0.0,151793,0,35983,19323,0,0
2020-04-19,0,,0,0,,,0.0,151793,0,35983,19323,0,0
2020-04-20,3590,0.0,1426,942,0.0,,0.0,155383,0,37409,20265,0,0
2020-04-21,1110,0.0,628,531,0.0,,0.0,156493,0,38037,20796,0,0
2020-04-22,0,,0,0,,,0.0,156493,0,38037,20796,0,0
2020-04-23,3384,0.0,2620,544,0.0,,0.0,159877,0,40657,21340,0,0
2020-04-24,0,,0,0,,,0.0,159877,0,40657,21340,0,0
2020-04-25,1611,0.0,3937,1274,0.0,,0.0,161488,0,44594,22614,0,0
2020-04-26,612,0.0,309,242,0.0,,0.0,162100,0,44903,22856,0,0
2020-04-27,3742,0.0,610,437,0.0,,0.0,165842,0,45513,23293,0,0
2020-04-28,69,0.0,1373,367,0.0,,0.0,165911,0,46886,23660,0,0
2020-04-29,0,,0,0,,,0.0,165911,0,46886,23660,0,0
2020-04-30,1267,0.0,2590,716,0.0,,0.0,167178,0,49476,24376,0,0
2020-05-01,168,0.0,736,218,0.0,,0.0,167346,0,50212,24594,0,0
2020-05-02,1050,0.0,350,166,0.0,,0.0,168396,0,50562,24760,0,0
2020-05-03,297,0.0,222,135,0.0,,0.0,168693,0,50784,24895,0,0
2020-05-04,769,0.0,587,306,0.0,,0.0,169462,0,51371,25201,0,0
2020-05-05,1089,0.0,1365,330,0.0,,0.0,170551,0,52736,25531,0,0
2020-05-06,3640,0.0,1236,278,0.0,,0.0,174191,0,53972,25809,0,0
2020-05-07,600,0.0,1055,178,0.0,,0.0,174791,0,55027,25987,0,0
2020-05-08,1288,0.0,755,243,0.0,,0.0,176079,0,55782,26230,0,0
2020-05-09,579,0.0,256,80,0.0,,0.0,176658,0,56038,26310,0,0
2020-05-10,312,0.0,179,70,0.0,,0.0,176970,0,56217,26380,0,0
2020-05-11,0,,0,0,,,0.0,176970,0,56217,26380,0,0
2020-05-12,1255,0.0,1568,611,0.0,,0.0,178225,0,57785,26991,0,0
2020-05-13,0,0.0,888,83,0.0,,0.0,178225,0,58673,27074,0,0
2020-05-14,645,0.0,932,351,0.0,,0.0,178870,0,59605,27425,0,0
2020-05-15,636,0.0,843,104,0.0,,0.0,179506,0,60448,27529,0,0
2020-05-17,124,0.0,618,96,0.0,,0.0,179630,0,61066,27625,0,0
2020-05-18,297,0.0,662,614,0.0,,0.0,179927,0,61728,28239,0,0
2020-05-19,882,0.0,835,0,0.0,,0.0,180809,0,62563,28239,0,0
2020-05-20,766,0.0,791,-107,0.0,,0.0,181575,0,63354,28132,0,0
2020-05-21,251,0.0,504,83,0.0,,0.0,181826,0,63858,28215,0,0
2020-05-22,393,0.0,351,74,0.0,,0.0,182219,0,64209,28289,0,0
2020-05-23,250,0.0,338,43,0.0,,0.0,182469,0,64547,28332,0,0
2020-05-24,115,0.0,70,35,0.0,,0.0,182584,0,64617,28367,0,0
2020-05-25,358,0.0,582,65,0.0,,0.0,182942,0,65199,28432,0,0
2020-05-26,-220,0.0,680,98,0.0,,0.0,182722,0,65879,28530,0,0
2020-05-27,191,0.0,705,66,0.0,,0.0,182913,0,66584,28596,0,0
2020-05-28,3325,0.0,607,66,0.0,,0.0,186238,0,67191,28662,0,0
2020-05-29,597,0.0,612,52,0.0,,0.0,186835,0,67803,28714,0,0
2020-05-30,1790,0.0,465,57,0.0,,0.0,188625,0,68268,28771,0,0
2020-05-31,257,0.0,87,31,0.0,,0.0,188882,0,68355,28802,0,0
2020-06-01,338,0.0,85,31,0.0,,0.0,189220,0,68440,28833,0,0
2020-06-02,-37895,0.0,372,107,0.0,,0.0,151325,0,68812,28940,0,0
2020-06-03,352,0.0,643,81,0.0,,0.0,151677,0,69455,29021,0,0
2020-06-04,767,0.0,521,44,0.0,,0.0,152444,0,69976,29065,0,0
2020-06-05,611,0.0,528,46,0.0,,0.0,153055,0,70504,29111,0,0
2020-06-06,579,0.0,302,31,0.0,,0.0,153634,0,70806,29142,0,0
2020-06-07,343,0.0,36,13,0.0,,0.0,153977,0,70842,29155,0,0
2020-06-08,211,0.0,220,54,0.0,,0.0,154188,0,71062,29209,0,0
2020-06-09,403,0.0,444,87,0.0,,0.0,154591,0,71506,29296,0,0
2020-06-10,545,0.0,326,23,0.0,,0.0,155136,0,71832,29319,0,0
2020-06-11,2425,0.0,317,27,0.0,,0.0,157561,0,72149,29346,0,0
2020-06-12,5726,0.0,423,28,0.0,,0.0,163287,0,72572,29374,0,0
2020-06-13,2526,0.0,226,24,0.0,,0.0,165813,0,72798,29398,0,0
2020-06-14,5407,0.0,61,9,0.0,,0.0,171220,0,72859,29407,0,0
2020-06-15,12933,0.0,123,3,0.0,,0.0,184153,0,72982,29410,0,0
2020-06-16,10152,,186,29,,,0.0,194305,0,73168,29439,0,0
2020-06-17,42,,291,111,,,0.0,194347,0,73459,29550,0,0
2020-06-18,458,,332,28,,,0.0,194805,0,73791,29578,0,0
2020-06-19,467,,220,28,,,0.0,195272,0,74011,29606,0,0
2020-06-20,811,,230,14,,,0.0,196083,0,74241,29620,0,0
2020-06-21,641,,195,16,,,0.0,196724,0,74436,29636,0,0
2020-06-22,284,,60,7,,,0.0,197008,0,74496,29643,0,0
2020-06-23,373,,240,23,,,0.0,197381,0,74736,29666,0,0
2020-06-24,423,,259,57,,,0.0,197804,0,74995,29723,0,0
2020-06-25,81,,256,11,,,0.0,197885,0,75251,29734,0,0
2020-06-26,0,,224,21,,,0.0,197885,0,75475,29755,0,0
2020-06-27,1588,,298,26,,,0.0,199473,0,75773,29781,0,0
2020-06-28,0,,0,0,,,0.0,199473,0,75773,29781,0,0
2020-06-29,3,,1,0,,,0.0,199476,0,75774,29781,0,0
2020-06-30,2046,,350,35,,,0.0,201522,0,76124,29816,0,0
2020-07-01,541,,275,30,,,0.0,202063,0,76399,29846,0,0
2020-07-02,1577,,528,32,,,0.0,203640,0,76927,29878,0,0
2020-07-03,0,,0,0,,,0.0,203640,0,76927,29878,0,0
2020-07-06,582,,258,18,,,0.0,204222,0,77185,29896,0,0
2020-07-07,1375,,259,27,,,0.0,205597,0,77444,29923,0,0
2020-07-08,475,,336,13,,,0.0,206072,0,77780,29936,0,0
2020-07-09,663,,341,32,,,0.0,206735,0,78121,29968,0,0
2020-07-10,621,,174,14,,,0.0,207356,0,78295,29982,0,0
2020-07-11,659,,218,25,,,0.0,208015,0,78513,30007,0,0
2020-07-12,0,,0,0,,,0.0,208015,0,78513,30007,0,0
2020-07-13,0,,0,0,,,0.0,208015,0,78513,30007,0,0
2020-07-14,1625,,209,25,,,0.0,209640,0,78722,30032,0,0
2020-07-15,1,,0,0,,,0.0,209641,0,78722,30032,0,0
2020-07-16,927,,223,91,,,0.0,210568,0,78945,30123,0,0
2020-07-17,534,,216,18,,,0.0,211102,0,79161,30141,0,0
2020-07-18,841,,210,14,,,0.0,211943,0,79371,30155,0,0
2020-07-19,0,,0,0,,,0.0,211943,0,79371,30155,0,0
2020-07-20,0,,0,0,,,0.0,211943,0,79371,30155,0,0
2020-07-21,2080,,297,25,,,0.0,214023,0,79668,30180,0,0
2020-07-22,584,,193,-12,,,0.0,214607,0,79861,30168,0,0
2020-07-23,998,,223,7,,,0.0,215605,0,80084,30175,0,0
2020-07-24,1062,,516,10,,,0.0,216667,0,80600,30185,0,0
2020-07-25,1130,,343,10,,,0.0,217797,0,80943,30195,0,0
2020-07-26,4,,2,0,,,0.0,217801,0,80945,30195,0,0
2020-07-27,0,,0,0,,,0.0,217801,0,80945,30195,0,0
2020-07-28,2551,,267,17,,,0.0,220352,0,81212,30212,0,0
2020-07-29,725,,229,14,,,0.0,221077,0,81441,30226,0,0
2020-07-30,1392,,191,15,,,0.0,222469,0,81632,30241,0,0
2020-07-31,0,,0,0,,,0.0,222469,0,81632,30241,0,0
2020-08-01,2728,,132,27,,,0.0,225197,0,81764,30268,0,0
2020-08-02,1,,0,0,,,0.0,225198,0,81764,30268,0,0
2020-08-03,0,,0,0,,,0.0,225198,0,81764,30268,0,0
2020-08-04,3376,,0,29,,,0.0,228574,0,81764,30297,0,0
2020-08-05,2,,0,0,,,0.0,228576,0,81764,30297,0,0
2020-08-06,2734,,828,11,,,0.0,231310,0,82592,30308,0,0
2020-08-07,0,,0,0,,,0.0,231310,0,82592,30308,0,0
2020-08-08,3898,,376,19,,,0.0,235208,0,82968,30327,0,0
2020-08-09,4,,0,0,,,0.0,235212,0,82968,30327,0,0
2020-08-10,4094,,3,0,,,0.0,239306,0,82971,30327,0,0
2020-08-11,49,,0,0,,,0.0,239355,0,82971,30327,0,0
2020-08-12,2182,,401,31,,,0.0,241537,0,83372,30358,0,0
2020-08-13,2559,,240,17,,,0.0,244096,0,83612,30375,0,0
2020-08-14,0,,0,17,,,0.0,244096,0,83612,30392,0,0
2020-08-15,5559,,381,18,,,0.0,249655,0,83993,30410,0,0
2020-08-16,3310,,0,0,,,0.0,252965,0,83993,30410,0,0
2020-08-17,3015,,0,0,,,0.0,255980,0,83993,30410,0,0
2020-08-18,554,,221,24,,,0.0,256534,0,84214,30434,0,0
2020-08-19,0,,0,0,,,0.0,256534,0,84214,30434,0,0
2020-08-20,0,,0,0,,,0.0,256534,0,84214,30434,0,0
2020-08-21,0,,0,0,,,0.0,256534,0,84214,30434,0,0
2020-08-22,15426,,767,74,,,0.0,271960,0,84981,30508,0,0
2020-08-23,3602,,121,9,,,0.0,275562,0,85102,30517,0,0
2020-08-24,4897,,24,1,,,0.0,280459,0,85126,30518,0,0
2020-08-25,1955,,226,15,,,0.0,282414,0,85352,30533,0,0
2020-08-26,3488,,405,16,,,0.0,285902,0,85757,30549,0,0
2020-08-27,11583,,514,37,,,0.0,297485,0,86271,30586,0,0
2020-08-28,0,,0,-5,,,0.0,297485,0,86271,30581,0,0
2020-08-29,7462,,224,20,,,0.0,304947,0,86495,30601,0,0
2020-08-30,5453,,0,6,,,0.0,310400,0,86495,30607,0,0
2020-08-31,5413,,133,4,,,0.0,315813,0,86628,30611,0,0
2020-09-01,8155,,405,55,,,0.0,323968,0,87033,30666,0,0
2020-09-02,0,,3,0,,,0.0,323968,0,87036,30666,0,0
2020-09-03,7092,,382,26,,,0.0,331060,0,87418,30692,0,0
2020-09-04,16135,,485,38,,,0.0,347195,0,87903,30730,0,0
2020-09-05,72,,24,0,,,0.0,347267,0,87927,30730,0,0
2020-09-06,1,,0,0,,,0.0,347268,0,87927,30730,0,0
2020-09-07,19827,,389,2,,,0.0,367095,0,88316,30732,0,0
2020-09-08,79,,170,0,,,0.0,367174,0,88486,30732,0,0
2020-09-09,6614,,390,38,,,0.0,373788,0,88876,30770,0,0
2020-09-10,9505,,366,35,,,0.0,383293,0,89242,30805,0,0
2020-09-11,8950,,226,14,,,0.0,392243,0,89468,30819,0,0
2020-09-12,10440,,923,83,,,0.0,402683,0,90391,30902,0,0
2020-09-13,128,,54,1,,,0.0,402811,0,90445,30903,0,0
2020-09-14,16746,,-382,21,,,0.0,419557,0,90063,30924,0,0
2020-09-15,6313,,369,34,,,0.0,425870,0,90432,30958,0,0
2020-09-16,17636,,828,95,,,0.0,443506,0,91260,31053,0,0
2020-09-17,363,,33,3,,,0.0,443869,0,91293,31056,0,0
2020-09-18,10433,,503,47,,,0.0,454302,0,91796,31103,0,0
2020-09-19,13217,,997,154,,,0.0,467519,0,92793,31257,0,0
2020-09-20,95,,793,0,,,0.0,467614,0,93586,31257,0,0
2020-09-21,23939,,277,36,,,0.0,491553,0,93863,31293,0,0
2020-09-22,5421,,568,53,,,0.0,496974,0,94431,31346,0,0
2020-09-23,10176,,530,80,,,0.0,507150,0,94961,31426,0,0
2020-09-24,13043,,588,46,,,0.0,520193,0,95549,31472,0,0
2020-09-25,16096,,909,107,,,0.0,536289,0,96458,31579,0,0
2020-09-26,16133,,451,96,,,0.0,552422,0,96909,31675,0,0
2020-09-27,51,,28,0,,,0.0,552473,0,96937,31675,0,0
2020-09-28,25475,,154,69,,,0.0,577948,0,97091,31744,0,0
2020-09-29,4022,,444,79,,,0.0,581970,0,97535,31823,0,0
2020-09-30,8162,,554,87,,,0.0,590132,0,98089,31910,0,0
2020-10-01,13899,,543,76,,,0.0,604031,0,98632,31986,0,0
2020-10-02,12955,,522,48,,,0.0,616986,0,99154,32034,0,0
2020-10-03,12445,,1099,137,,,0.0,629431,0,100253,32171,0,0
2020-10-04,78,,28,0,,,0.0,629509,0,100281,32171,0,0
2020-10-05,34375,,333,144,,,0.0,663884,0,100614,32315,0,0
2020-10-06,405,,259,2,,,0.0,664289,0,100873,32317,0,0
2020-10-07,29094,,1068,145,,,0.0,693383,0,101941,32462,0,0
2020-10-08,220,,120,1,,,0.0,693603,0,102061,32463,0,0
2020-10-09,18101,,481,76,,,0.0,711704,0,102542,32539,0,0
2020-10-10,20730,,690,62,,,0.0,732434,0,103232,32601,0,0
2020-10-11,0,,0,0,,,0.0,732434,0,103232,32601,0,0
2020-10-12,43130,,663,101,,,0.0,775564,0,103895,32702,0,0
2020-10-13,533,,140,1,,,0.0,776097,0,104035,32703,0,0
2020-10-14,22160,,1168,279,,,0.0,798257,0,105203,32982,0,0
2020-10-15,22119,,1171,76,,,0.0,820376,0,106374,33058,0,0
2020-10-16,30621,,669,88,,,0.0,850997,0,107043,33146,0,0
2020-10-17,25345,,971,179,,,0.0,876342,0,108014,33325,0,0
2020-10-18,0,,0,0,,,0.0,876342,0,108014,33325,0,0
2020-10-19,62393,,735,174,,,0.0,938735,0,108749,33499,0,0
2020-10-20,13865,,862,148,,,0.0,952600,0,109611,33647,0,0
2020-10-21,20675,,904,281,,,0.0,973275,0,110515,33928,0,0
2020-10-22,27094,,1200,147,,,0.0,1000369,0,111715,34075,0,0
2020-10-23,41622,,947,162,,,0.0,1041991,0,112662,34237,0,0
2020-10-24,42668,,974,299,,,0.0,1084659,0,113636,34536,0,0
2020-10-25,45422,,836,137,,,0.0,1130081,0,114472,34673,0,0
2020-10-26,52072,,400,116,,,0.0,1182153,0,114872,34789,0,0
2020-10-27,27498,,1092,263,,,0.0,1209651,0,115964,35052,0,0
2020-10-28,34747,,1436,532,,,0.0,1244398,0,117400,35584,0,0
2020-10-29,35817,,2013,239,,,0.0,1280215,0,119413,35823,0,0
2020-10-30,47638,,1311,235,,,0.0,1327853,0,120724,36058,0,0
2020-10-31,49494,,1500,547,,,0.0,1377347,0,122224,36605,0,0
2020-11-01,35362,,871,221,,,0.0,1412709,0,123095,36826,0,0
2020-11-02,46290,,569,231,,,0.0,1458999,0,123664,37057,0,0
2020-11-03,1746,,0,428,,,0.0,1460745,0,123664,37485,0,0
2020-11-04,646,,0,7,,,0.0,1461391,0,123664,37492,0,0
2020-11-05,81930,,-1002,1182,,,0.0,1543321,0,122662,38674,0,0
2020-11-06,105668,,7097,414,,,0.0,1648989,0,129759,39088,0,0
2020-11-07,60727,,2051,828,,,0.0,1709716,0,131810,39916,0,0
2020-11-08,57,,1609,304,,,0.0,1709773,0,133419,40220,0,0
2020-11-09,77551,,-4805,219,,,0.0,1787324,0,128614,40439,0,0
2020-11-10,68968,,6602,610,,,0.0,1856292,0,135216,41049,0,0
2020-11-11,1017,,0,13,,,0.0,1857309,0,135216,41062,0,0
2020-11-12,57610,,3961,1537,,,0.0,1914919,0,139177,42599,0,0
2020-11-13,363,,35,0,,,0.0,1915282,0,139212,42599,0,0
2020-11-14,395,,548,1,,,0.0,1915677,0,139760,42600,0,0
2020-11-15,36,,0,0,,,0.0,1915713,0,139760,42600,0,0
2020-11-16,302,,0,3,,,0.0,1916015,0,139760,42603,0,0
2020-11-17,75218,,1120,2451,,,0.0,1991233,0,140880,45054,0,0
2020-11-18,95950,,7789,1292,,,0.0,2087183,0,148669,46346,0,0
2020-11-19,28534,,2298,426,,,0.0,2115717,0,150967,46772,0,0
2020-11-20,21379,,2178,429,,,0.0,2137096,0,153145,47201,0,0
2020-11-21,23249,,2686,1140,,,0.0,2160345,0,155831,48341,0,0
2020-11-22,27,,0,0,,,0.0,2160372,0,155831,48341,0,0
2020-11-23,30808,,1428,466,,,0.0,2191180,0,157259,48807,0,0
2020-11-24,4760,,911,505,,,0.0,2195940,0,158170,49312,0,0
2020-11-25,10186,,2087,1015,,,0.0,2206126,0,160257,50327,0,0
2020-11-26,15748,,1873,373,,,0.0,2221874,0,162130,50700,0,0
2020-11-27,13767,,1684,342,,,0.0,2235641,0,163814,51042,0,0
2020-11-28,12568,,1679,957,,,0.0,2248209,0,165493,51999,0,0
2020-11-29,12580,,1222,213,,,0.0,2260789,0,166715,52212,0,0
2020-11-30,9784,,290,198,,,0.0,2270573,0,167005,52410,0,0
2020-12-01,4443,,908,409,,,0.0,2275016,0,167913,52819,0,0
2020-12-02,413,,2,2,,,0.0,2275429,0,167915,52821,0,0
2020-12-03,91,,0,0,,,0.0,2275520,0,167915,52821,0,0
2020-12-04,34751,,4659,1410,,,0.0,2310271,0,172574,54231,0,0
2020-12-05,11432,,1412,628,,,0.0,2321703,0,173986,54859,0,0
2020-12-06,12923,,1006,214,,,0.0,2334626,0,174992,55073,0,0
2020-12-07,11022,,228,174,,,0.0,2345648,0,175220,55247,0,0
2020-12-08,3411,,699,366,,,0.0,2349059,0,175919,55613,0,0
2020-12-09,14138,,1639,840,,,0.0,2363197,0,177558,56453,0,0
2020-12-10,14714,,1379,299,,,0.0,2377911,0,178937,56752,0,0
2020-12-11,13732,,1411,292,,,0.0,2391643,0,180348,57044,0,0
2020-12-12,13567,,1233,627,,,0.0,2405210,0,181581,57671,0,0
2020-12-13,45,,0,0,,,0.0,2405255,0,181581,57671,0,0
2020-12-14,25357,,1107,344,,,0.0,2430612,0,182688,58015,0,0
2020-12-15,3247,,652,376,,,0.0,2433859,0,183340,58391,0,0
2020-12-16,13599,,1440,791,,,0.0,2447458,0,184780,59182,0,0
2020-12-17,17788,,1224,290,,,0.0,2465246,0,186004,59472,0,0
2020-12-18,18415,,1195,263,,,0.0,2483661,0,187199,59735,0,0
2020-12-19,16078,,1289,612,,,0.0,2499739,0,188488,60347,0,0
2020-12-20,17398,,915,188,,,0.0,2517137,0,189403,60535,0,0
2020-12-21,12619,,235,130,,,0.0,2529756,0,189638,60665,0,0
2020-12-22,6025,,660,354,,,0.0,2535781,0,190298,61019,0,0
2020-12-23,11862,,1594,802,,,0.0,2547643,0,191892,61821,0,0
2020-12-24,14972,,1300,277,,,0.0,2562615,0,193192,62098,0,0
2020-12-25,21856,,1367,291,,,0.0,2584471,0,194559,62389,0,0
2020-12-26,20124,,806,159,,,0.0,2604595,0,195365,62548,0,0
2020-12-27,3682,,273,146,,,0.0,2608277,0,195638,62694,0,0
2020-12-28,8233,,223,173,,,0.0,2616510,0,195861,62867,0,0
2020-12-29,3159,,781,368,,,0.0,2619669,0,196642,63235,0,0
2020-12-30,11506,,1085,969,,,0.0,2631175,0,197727,64204,0,0
2020-12-31,26598,,1239,304,,,0.0,2657773,0,198966,64508,0,0
2021-01-01,20033,,1176,252,,,0.0,2677806,0,200142,64760,0,0
2021-01-02,19208,,680,132,,,0.0,2697014,0,200822,64892,0,0
2021-01-03,3466,,273,156,,,0.0,2700480,0,201095,65048,0,0
2021-01-04,12495,,213,116,,,0.0,2712975,0,201308,65164,0,0
2021-01-05,4293,,651,386,,,0.0,2717268,0,201959,65550,0,0
2021-01-06,20739,,1467,867,,,0.0,2738007,0,203426,66417,0,0
2021-01-07,25244,,1254,283,,,0.0,2763251,0,204680,66700,0,0
2021-01-08,312,,1,0,,,0.0,2763563,0,204681,66700,0,0
2021-01-09,41325,,2530,867,,,0.0,2804888,0,207211,67567,0,0
2021-01-10,20175,,879,167,,,0.0,2825063,0,208090,67734,0,0
2021-01-11,15801,,264,151,,,0.0,2840864,0,208354,67885,0,0
2021-01-12,4166,,643,313,,,0.0,2845030,0,208997,68198,0,0
2021-01-13,19479,,1319,741,,,0.0,2864509,0,210316,68939,0,0
2021-01-14,23939,,1282,229,,,0.0,2888448,0,211598,69168,0,0
2021-01-15,21478,,1130,284,,,0.0,2909926,0,212728,69452,0,0
2021-01-16,21720,,1269,638,,,0.0,2931646,0,213997,70090,0,0
2021-01-17,239,,0,4,,,0.0,2931885,0,213997,70094,0,0
2021-01-18,37206,,1275,328,,,0.0,2969091,0,215272,70422,0,0
2021-01-19,4067,,857,406,,,0.0,2973158,0,216129,70828,0,0
2021-01-20,23626,,1616,654,,,0.0,2996784,0,217745,71482,0,0
2021-01-21,27001,,1609,310,,,0.0,3023785,0,219354,71792,0,0
2021-01-22,22706,,1296,347,,,0.0,3046491,0,220650,72139,0,0
2021-01-23,23509,,1287,650,,,0.0,3070000,0,221937,72789,0,0
2021-01-24,23723,,903,229,,,0.0,3093723,0,222840,73018,0,0
2021-01-25,18332,,240,172,,,0.0,3112055,0,223080,73190,0,0
2021-01-26,4307,,743,446,,,0.0,3116362,0,223823,73636,0,0
2021-01-27,22136,,1444,614,,,0.0,3138498,0,225267,74250,0,0
2021-01-28,27106,,1418,350,,,0.0,3165604,0,226685,74600,0,0
2021-01-29,619,,88,1,,,0.0,3166223,0,226773,74601,0,0
2021-01-30,46513,,2864,1164,,,0.0,3212736,0,229637,75765,0,0
2021-01-31,24104,,689,241,,,0.0,3236840,0,230326,76006,0,0
2021-02-01,19080,,286,195,,,0.0,3255920,0,230612,76201,0,0
2021-02-02,4511,,913,458,,,0.0,3260431,0,231525,76659,0,0
2021-02-03,23265,,1577,724,,,0.0,3283696,0,233102,77383,0,0
2021-02-04,26355,,1576,358,,,0.0,3310051,0,234678,77741,0,0
2021-02-05,23468,,1503,357,,,0.0,3333519,0,236181,78098,0,0
2021-02-06,22159,,1574,651,,,0.0,3355678,0,237755,78749,0,0
2021-02-07,20588,,1144,191,,,0.0,3376266,0,238899,78940,0,0
2021-02-08,19719,,284,171,,,0.0,3395985,0,239183,79111,0,0
2021-02-09,4564,,1017,461,,,0.0,3400549,0,240200,79572,0,0
2021-02-10,18661,,1724,723,,,0.0,3419210,0,241924,80295,0,0
2021-02-11,25678,,1397,296,,,0.0,3444888,0,243321,80591,0,0
2021-02-12,21078,,1641,360,,,0.0,3465966,0,244962,80951,0,0
2021-02-13,823,,0,4,,,0.0,3466789,0,244962,80955,0,0
2021-02-14,262,,0,0,,,0.0,3467051,0,244962,80955,0,0
2021-02-15,57399,,2875,1007,,,0.0,3524450,0,247837,81962,0,0
2021-02-16,4622,,900,416,,,0.0,3529072,0,248737,82378,0,0
2021-02-17,19891,,1711,587,,,0.0,3548963,0,250448,82965,0,0
2021-02-18,24678,,1499,306,,,0.0,3573641,0,251947,83271,0,0
2021-02-19,22515,,1390,271,,,0.0,3596156,0,253337,83542,0,0
2021-02-20,84,,0,4,,,0.0,3596240,0,253337,83546,0,0
2021-02-21,873,,0,0,,,0.0,3597113,0,253337,83546,0,0
2021-02-22,67587,,2606,884,,,0.0,3664700,0,255943,84430,0,0
2021-02-23,4862,,805,337,,,0.0,3669562,0,256748,84767,0,0
2021-02-24,19972,,2115,428,,,0.0,3689534,0,258863,85195,0,0
2021-02-25,31529,,1367,278,,,0.0,3721063,0,260230,85473,0,0
2021-02-26,25413,,1419,261,,,0.0,3746476,0,261649,85734,0,0
2021-02-27,787,,0,7,,,0.0,3747263,0,261649,85741,0,0
2021-02-28,0,,0,0,,,0.0,3747263,0,261649,85741,0,0
2021-03-01,68376,,2687,839,,,0.0,3815639,0,264336,86580,0,0
2021-03-02,4730,,829,375,,,0.0,3820369,0,265165,86955,0,0
2021-03-03,22872,,1512,418,,,0.0,3843241,0,266677,87373,0,0
2021-03-04,26903,,1396,322,,,0.0,3870144,0,268073,87695,0,0
2021-03-05,25286,,1401,293,,,0.0,3895430,0,269474,87988,0,0
2021-03-06,24203,,1229,447,,,0.0,3919633,0,270703,88435,0,0
2021-03-07,22611,,990,162,,,0.0,3942244,0,271693,88597,0,0
2021-03-08,21834,,386,130,,,0.0,3964078,0,272079,88727,0,0
2021-03-09,5537,,809,363,,,0.0,3969615,0,272888,89090,0,0
2021-03-10,23144,,1443,365,,,0.0,3992759,0,274331,89455,0,0
2021-03-11,30427,,1480,264,,,0.0,4023186,0,275811,89719,0,0
2021-03-12,27420,,1414,265,,,0.0,4050606,0,277225,89984,0,0
2021-03-13,25200,,1245,223,,,0.0,4075806,0,278470,90207,0,0
2021-03-14,30141,,937,169,,,0.0,4105947,0,279407,90376,0,0
2021-03-15,25935,,345,207,,,0.0,4131882,0,279752,90583,0,0
2021-03-16,269,,811,341,,,0.0,4132151,0,280563,90924,0,0
2021-03-17,36288,,1589,400,,,0.0,4168439,0,282152,91324,0,0
2021-03-18,38599,,1633,246,,,0.0,4207038,0,283785,91570,0,0
2021-03-19,34950,,1270,263,,,0.0,4241988,0,285055,91833,0,0
2021-03-20,168,,4,10,,,0.0,4242156,0,285059,91843,0,0
2021-03-21,35630,,1383,276,,,0.0,4277786,0,286442,92119,0,0
2021-03-22,10,,2,0,,,0.0,4277796,0,286444,92119,0,0
2021-03-23,81114,,2239,657,,,0.0,4358910,0,288683,92776,0,0
2021-03-24,14709,,1627,289,,,0.0,4373619,0,290310,93065,0,0
2021-03-25,1166,,0,18,,,0.0,4374785,0,290310,93083,0,0
2021-03-26,110032,,3100,454,,,0.0,4484817,0,293410,93537,0,0
2021-03-27,41728,,1481,896,,,0.0,4526545,0,294891,94433,0,0
2021-03-28,43458,,1288,197,,,0.0,4570003,0,296179,94630,0,0
2021-03-29,36193,,402,124,,,0.0,4606196,0,296581,94754,0,0
2021-03-30,9106,,1058,360,,,0.0,4615302,0,297639,95114,0,0
2021-03-31,30723,,1986,381,,,0.0,4646025,0,299625,95495,0,0
2021-04-01,59259,,1842,307,,,0.0,4705284,0,301467,95802,0,0
2021-04-02,50496,,1528,304,,,0.0,4755780,0,302995,96106,0,0
2021-04-03,46683,,1568,332,,,0.0,4802463,0,304563,96438,0,0
2021-04-04,82,,0,1,,,0.0,4802545,0,304563,96439,0,0
2021-04-05,80633,,1890,369,,,0.0,4883178,0,306453,96808,0,0
2021-04-06,10795,,440,200,,,0.0,4893973,0,306893,97008,0,0
2021-04-07,8053,,1235,423,,,0.0,4902026,0,308128,97431,0,0
2021-04-08,1151,,0,15,,,0.0,4903177,0,308128,97446,0,0
2021-04-09,96979,,4412,756,,,0.0,5000156,0,312540,98202,0,0
2021-04-10,158,,0,0,,,0.0,5000314,0,312540,98202,0,0
2021-04-11,1371,,0,11,,,0.0,5001685,0,312540,98213,0,0
2021-04-12,117905,,4076,696,,,0.0,5119590,0,316616,98909,0,0
2021-04-13,8550,,1147,385,,,0.0,5128140,0,317763,99294,0,0
2021-04-14,39282,,2117,345,,,0.0,5167422,0,319880,99639,0,0
2021-04-15,43350,,2101,297,,,0.0,5210772,0,321981,99936,0,0
2021-04-16,38159,,1884,296,,,0.0,5248931,0,323865,100232,0,0
2021-04-17,36376,,1887,331,,,0.0,5285307,0,325752,100563,0,0
2021-04-18,36608,,1352,194,,,0.0,5321915,0,327104,100757,0,0
2021-04-19,28606,,482,135,,,0.0,5350521,0,327586,100892,0,0
2021-04-20,6709,,1132,447,,,0.0,5357230,0,328718,101339,0,0
2021-04-21,44256,,2072,375,,,0.0,5401486,0,330790,101714,0,0
2021-04-22,34743,,1850,332,,,0.0,5436229,0,332640,102046,0,0
2021-04-23,33729,,1857,277,,,0.0,5469958,0,334497,102323,0,0
2021-04-24,32065,,1737,332,,,0.0,5502023,0,336234,102655,0,0
2021-04-25,32633,,1433,217,,,0.0,5534656,0,337667,102872,0,0
2021-04-26,26043,,524,166,,,0.0,5560699,0,338191,103038,0,0
2021-04-27,4382,,1201,377,,,0.0,5565081,0,339392,103415,0,0
2021-04-28,30500,,2015,349,,,0.0,5595581,0,341407,103764,0,0
2021-04-29,31499,,1704,313,,,0.0,5627080,0,343111,104077,0,0
2021-04-30,26618,,1719,308,,,0.0,5653698,0,344830,104385,0,0
2021-05-01,24316,,1650,290,,,0.0,5678014,0,346480,104675,0,0
2021-05-02,25491,,15102,192,,,0.0,5703505,0,361582,104867,0,0
2021-05-03,9888,,461,113,,,0.0,5713393,0,362043,104980,0,0
2021-05-04,3921,,998,314,,,0.0,5717314,0,363041,105294,0,0
2021-05-05,25478,,1818,256,,,0.0,5742792,0,364859,105550,0,0
2021-05-06,24946,,1923,242,,,0.0,5767738,0,366782,105792,0,0
2021-05-07,21693,,1591,219,,,0.0,5789431,0,368373,106011,0,0
2021-05-08,18990,,1525,251,,,0.0,5808421,0,369898,106262,0,0
2021-05-09,20745,,1178,176,,,0.0,5829166,0,371076,106438,0,0
2021-05-10,9128,,402,115,,,0.0,5838294,0,371478,106553,0,0
2021-05-11,3577,,922,294,,,0.0,5841871,0,372400,106847,0,0
2021-05-12,19746,,1575,249,,,0.0,5861617,0,373975,107096,0,0
2021-05-13,21265,,1490,184,,,0.0,5882882,0,375465,107280,0,0
2021-05-14,20017,,1067,133,,,0.0,5902899,0,376532,107413,0,0
2021-05-15,6487,,806,171,,,0.0,5909386,0,377338,107584,0,0
2021-05-16,15685,,1305,112,,,0.0,5925071,0,378643,107696,0,0
2021-05-17,13948,,315,81,,,0.0,5939019,0,378958,107777,0,0
2021-05-18,4560,,854,209,,,0.0,5943579,0,379812,107986,0,0
2021-05-19,16014,,1439,215,,,0.0,5959593,0,381251,108201,0,0
2021-05-20,19327,,1250,142,,,0.0,5978920,0,382501,108343,0,0
2021-05-21,446,,0,0,,,0.0,5979366,0,382501,108343,0,0
2021-05-22,3,,16,0,,,0.0,5979369,0,382517,108343,0,0
2021-05-23,228,,2,2,,,0.0,5979597,0,382519,108345,0,0
2021-05-24,728,,0,13,,,0.0,5980325,0,382519,108358,0,0
2021-05-25,-312673,,3442,462,,,0.0,5667652,0,385961,108820,0,0
2021-05-26,2905,,837,221,,,0.0,5670557,0,386798,109041,0,0
2021-05-27,12586,,1330,144,,,0.0,5683143,0,388128,109185,0,0
2021-05-28,14375,,982,144,,,0.0,5697518,0,389110,109329,0,0
2021-05-29,10833,,1088,123,,,0.0,5708351,0,390198,109452,0,0
2021-05-30,12073,,680,68,,,0.0,5720424,0,390878,109520,0,0
2021-05-31,7994,,225,42,,,0.0,5728418,0,391103,109562,0,0
2021-06-01,643,,567,128,,,0.0,5729061,0,391670,109690,0,0
2021-06-02,9756,,923,137,,,0.0,5738817,0,392593,109827,0,0
2021-06-03,1331,,3,15,,,0.0,5740148,0,392596,109842,0,0
2021-06-04,15700,,1536,149,,,0.0,5755848,0,394132,109991,0,0
2021-06-05,6789,,789,87,,,0.0,5762637,0,394921,110078,0,0
2021-06-06,6654,,463,57,,,0.0,5769291,0,395384,110135,0,0
2021-06-07,5261,,135,25,,,0.0,5774552,0,395519,110160,0,0
2021-06-08,1193,,500,69,,,0.0,5775745,0,396019,110229,0,0
2021-06-09,5969,,668,73,,,0.0,5781714,0,396687,110302,0,0
2021-06-10,5610,,773,63,,,0.0,5787324,0,397460,110365,0,0
2021-06-11,4284,,632,67,,,0.0,5791608,0,398092,110432,0,0
2021-06-12,3879,,635,74,,,0.0,5795487,0,398727,110506,0,0
2021-06-13,3972,,365,34,,,0.0,5799459,0,399092,110540,0,0
2021-06-14,2855,,102,13,,,0.0,5802314,0,399194,110553,0,0
2021-06-15,980,,366,66,,,0.0,5803294,0,399560,110619,0,0
2021-06-16,3124,,700,73,,,0.0,5806418,0,400260,110692,0,0
2021-06-17,3187,,536,48,,,0.0,5809605,0,400796,110740,0,0
2021-06-18,1856,,568,56,,,0.0,5811461,0,401364,110796,0,0
2021-06-19,3187,,472,68,,,0.0,5814648,0,401836,110864,0,0
2021-06-20,2625,,263,22,,,0.0,5817273,0,402099,110886,0,0
2021-06-21,2330,,49,20,,,0.0,5819603,0,402148,110906,0,0
2021-06-22,178,,317,35,,,0.0,5819781,0,402465,110941,0,0
2021-06-23,2168,,457,50,,,0.0,5821949,0,402922,110991,0,0
2021-06-24,2178,,404,33,,,0.0,5824127,0,403326,111024,0,0
2021-06-25,2392,,471,44,,,0.0,5826519,0,403797,111068,0,0
2021-06-26,1747,,310,33,,,0.0,5828266,0,404107,111101,0,0
2021-06-27,2128,,225,12,,,0.0,5830394,0,404332,111113,0,0
2021-06-28,1824,,63,17,,,0.0,5832218,0,404395,111130,0,0
2021-06-29,503,,271,45,,,0.0,5832721,0,404666,111175,0,0
2021-06-30,3261,,322,57,,,0.0,5835982,0,404988,111232,0,0
2021-07-01,1283,,297,12,,,0.0,5837265,0,405285,111244,0,0
2021-07-02,2877,,287,30,,,0.0,5840142,0,405572,111274,0,0
2021-07-03,2474,,282,23,,,0.0,5842616,0,405854,111297,0,0
2021-07-04,3006,,165,17,,,0.0,5845622,0,406019,111314,0,0
2021-07-05,2906,,31,14,,,0.0,5848528,0,406050,111328,0,0
2021-07-06,483,,207,57,,,0.0,5849011,0,406257,111385,0,0
2021-07-07,3854,,282,41,,,0.0,5852865,0,406539,111426,0,0
2021-07-08,3817,,201,22,,,0.0,5856682,0,406740,111448,0,0
2021-07-09,4708,,230,28,,,0.0,5861390,0,406970,111476,0,0
2021-07-10,4377,,230,16,,,0.0,5865767,0,407200,111492,0,0
2021-07-11,4696,,172,19,,,0.0,5870463,0,407372,111511,0,0
2021-07-12,4874,,19,9,,,0.0,5875337,0,407391,111520,0,0
2021-07-13,790,,294,27,,,0.0,5876127,0,407685,111547,0,0
2021-07-14,6818,,280,50,,,0.0,5882945,0,407965,111597,0,0
2021-07-15,1710,,0,14,,,0.0,5884655,0,407965,111611,0,0
2021-07-16,10858,,318,8,,,0.0,5895513,0,408283,111619,0,0
2021-07-17,10935,,284,22,,,0.0,5906448,0,408567,111641,0,0
2021-07-18,10949,,142,16,,,0.0,5917397,0,408709,111657,0,0
2021-07-19,12827,,30,9,,,0.0,5930224,0,408739,111666,0,0
2021-07-20,4090,,234,20,,,0.0,5934314,0,408973,111686,0,0
2021-07-21,18165,,430,31,,,0.0,5952479,0,409403,111717,0,0
2021-07-22,21433,,284,20,,,0.0,5973912,0,409687,111737,0,0
2021-07-23,22148,,348,12,,,0.0,5996060,0,410035,111749,0,0
2021-07-24,19409,,314,29,,,0.0,6015469,0,410349,111778,0,0
2021-07-25,25677,,176,22,,,0.0,6041146,0,410525,111800,0,0
2021-07-26,15687,,29,12,,,0.0,6056833,0,410554,111812,0,0
2021-07-27,4971,,349,39,,,0.0,6061804,0,410903,111851,0,0
2021-07-28,27126,,2323,32,,,0.0,6088930,0,413226,111883,0,0
2021-07-29,27923,,-1429,40,,,0.0,6116853,0,411797,111923,0,0
2021-07-30,25429,,576,28,,,0.0,6142282,0,412373,111951,0,0
2021-07-31,24408,,432,60,,,0.0,6166690,0,412805,112011,0,0
2021-08-01,23644,,365,44,,,0.0,6190334,0,413170,112055,0,0
2021-08-02,19724,,108,20,,,0.0,6210058,0,413278,112075,0,0
2021-08-03,8468,,79,32,,,0.0,6218526,0,413357,112107,0,0
2021-08-04,24422,,1076,78,,,0.0,6242948,0,414433,112185,0,0
2021-08-05,29241,,678,48,,,0.0,6272189,0,415111,112233,0,0
2021-08-06,26460,,0,49,,,0.0,6298649,0,415111,112282,0,0
2021-08-07,489,,0,1,,,0.0,6299138,0,415111,112283,0,0
2021-08-08,26006,,0,64,,,0.0,6325144,0,415111,112347,0,0
2021-08-09,48653,,0,73,,,0.0,6373797,0,415111,112420,0,0
2021-08-10,1471,,0,10,,,0.0,6375268,0,415111,112430,0,0
2021-08-11,32020,,0,145,,,0.0,6407288,0,415111,112575,0,0
2021-08-12,32794,,0,45,,,0.0,6440082,0,415111,112620,0,0
2021-08-13,29671,,0,80,,,0.0,6469753,0,415111,112700,0,0
2021-08-14,0,,0,0,,,0.0,6469753,0,415111,112700,0,0
2021-08-15,1509,,0,5,,,0.0,6471262,0,415111,112705,0,0
2021-08-16,0,,0,0,,,0.0,6471262,0,415111,112705,0,0
2021-08-17,7804,,0,105,,,0.0,6479066,0,415111,112810,0,0
2021-08-18,102351,,0,306,,,0.0,6581417,0,415111,113116,0,0
2021-08-19,30027,,0,123,,,0.0,6611444,0,415111,113239,0,0
2021-08-20,25923,,0,139,,,0.0,6637367,0,415111,113378,0,0
2021-08-21,22949,,0,94,,,0.0,6660316,0,415111,113472,0,0
2021-08-22,22636,,0,0,,,0.0,6682952,0,415111,113472,0,0
2021-08-23,17953,,0,4,,,0.0,6700905,0,415111,113476,0,0
2021-08-24,7258,,0,381,,,0.0,6708163,0,415111,113857,0,0
2021-08-25,25914,,0,169,,,0.0,6734077,0,415111,114026,0,0
2021-08-26,23706,,0,118,,,0.0,6757783,0,415111,114144,0,0
2021-08-27,19893,,0,125,,,0.0,6777676,0,415111,114269,0,0
2021-08-28,1689,,0,142,,,0.0,6779365,0,415111,114411,0,0
2021-08-29,34151,,0,42,,,0.0,6813516,0,415111,114453,0,0
2021-08-30,13630,,0,53,,,0.0,6827146,0,415111,114506,0,0
2021-08-31,0,,0,0,,,0.0,6827146,0,415111,114506,0,0
2021-09-01,0,,0,0,,,0.0,6827146,0,415111,114506,0,0
2021-09-02,0,,0,0,,,0.0,6827146,0,415111,114506,0,0
2021-09-03,0,,0,0,,,0.0,6827146,0,415111,114506,0,0
2021-09-04,0,,0,0,,,0.0,6827146,0,415111,114506,0,0
2021-09-05,0,,0,0,,,0.0,6827146,0,415111,114506,0,0
2021-09-06,0,,0,0,,,0.0,6827146,0,415111,114506,0,0
2021-09-07,0,,0,0,,,0.0,6827146,0,415111,114506,0,0
2021-09-08,0,,0,0,,,0.0,6827146,0,415111,114506,0,0
2021-09-09,0,,0,0,,,0.0,6827146,0,415111,114506,0,0
2021-09-10,39710,,6027086,753,,,0.0,6866856,0,6442197,115259,0,0
2021-09-11,0,,0,0,,,0.0,6866856,0,6442197,115259,0,0
2021-09-12,0,,0,0,,,0.0,6866856,0,6442197,115259,0,0
2021-09-13,0,,0,0,,,0.0,6866856,0,6442197,115259,0,0
2021-09-14,40277,,91916,344,,,0.0,6907133,0,6534113,115603,0,0
2021-09-15,0,,0,0,,,0.0,6907133,0,6534113,115603,0,0
2021-09-16,19471,,43156,226,,,0.0,6926604,0,6577269,115829,0,0
2021-09-17,8128,,18170,65,,,0.0,6934732,0,6595439,115894,0,0
2021-09-18,0,,0,0,,,0.0,6934732,0,6595439,115894,0,0
2021-09-19,14787,,31089,108,,,0.0,6949519,0,6626528,116002,0,0
2021-09-20,5814,,3753,28,,,0.0,6955333,0,6630281,116030,0,0
2021-09-21,0,,0,0,,,0.0,6955333,0,6630281,116030,0,0
2021-09-22,9366,,36950,221,,,0.0,6964699,0,6667231,116251,0,0
2021-09-23,6794,,15758,58,,,0.0,6971493,0,6682989,116309,0,0
2021-09-24,0,,0,0,,,0.0,6971493,0,6682989,116309,0,0
2021-09-25,0,,0,0,,,0.0,6971493,0,6682989,116309,0,0
2021-09-26,18120,,37043,140,,,0.0,6989613,0,6720032,116449,0,0
2021-09-27,4706,,3013,14,,,0.0,6994319,0,6723045,116463,0,0
2021-09-28,0,,0,0,,,0.0,6994319,0,6723045,116463,0,0
2021-09-29,8074,,27256,152,,,0.0,7002393,0,6750301,116615,0,0
2021-09-30,5835,,10909,42,,,0.0,7008228,0,6761210,116657,0,0
2021-10-01,5204,,9924,56,,,0.0,7013432,0,6771134,116713,0,0
2021-10-02,4935,,9545,46,,,0.0,7018367,0,6780679,116759,0,0
2021-10-03,4948,,7633,30,,,0.0,7023315,0,6788312,116789,0,0
2021-10-04,3744,,2032,9,,,0.0,7027059,0,6790344,116798,0,0
2021-10-05,1138,,10318,50,,,0.0,7028197,0,6800662,116848,0,0
2021-10-06,5558,,9094,75,,,0.0,7033755,0,6809756,116923,0,0
2021-10-07,4946,,8053,34,,,0.0,7038701,0,6817809,116957,0,0
2021-10-08,4615,,7339,34,,,0.0,7043316,0,6825148,116991,0,0
2021-10-09,4470,,7380,38,,,0.0,7047786,0,6832528,117029,0,0
2021-10-10,4734,,5776,15,,,0.0,7052520,0,6838304,117044,0,0
2021-10-11,3991,,1500,8,,,0.0,7056511,0,6839804,117052,0,0
2021-10-12,1120,,7843,30,,,0.0,7057631,0,6847647,117082,0,0
2021-10-13,5880,,6764,68,,,0.0,7063511,0,6854411,117150,0,0
2021-10-14,5578,,6161,23,,,0.0,7069089,0,6860572,117173,0,0
2021-10-15,5187,,5856,38,,,0.0,7074276,0,6866428,117211,0,0
2021-10-16,6099,,5974,34,,,0.0,7080375,0,6872402,117245,0,0
2021-10-17,4899,,4672,15,,,0.0,7085274,0,6877074,117260,0,0
2021-10-18,3778,,1294,5,,,0.0,7089052,0,6878368,117265,0,0
2021-10-19,1057,,6760,41,,,0.0,7090109,0,6885128,117306,0,0
2021-10-20,5934,,5794,49,,,0.0,7096043,0,6890922,117355,0,0
2021-10-21,6036,,5155,21,,,0.0,7102079,0,6896077,117376,0,0
2021-10-22,6127,,4914,35,,,0.0,7108206,0,6900991,117411,0,0
2021-10-23,6366,,4913,29,,,0.0,7114572,0,6905904,117440,0,0
2021-10-24,6291,,3715,23,,,0.0,7120863,0,6909619,117463,0,0
2021-10-25,5005,,1115,4,,,0.0,7125868,0,6910734,117467,0,0
2021-10-26,1295,,5554,41,,,0.0,7127163,0,6916288,117508,0,0
2021-10-27,6603,,4905,47,,,0.0,7133766,0,6921193,117555,0,0
2021-10-28,6528,,4568,34,,,0.0,7140294,0,6925761,117589,0,0
2021-10-29,6461,,4436,33,,,0.0,7146755,0,6930197,117622,0,0
2021-10-30,6433,,4701,27,,,0.0,7153188,0,6934898,117649,0,0
2021-10-31,7360,,3964,22,,,0.0,7160548,0,6938862,117671,0,0
2021-11-01,6329,,1098,12,,,0.0,7166877,0,6939960,117683,0,0
2021-11-02,1866,,5868,6,,,0.0,7168743,0,6945828,117689,0,0
2021-11-03,2039,,5572,74,,,0.0,7170782,0,6951400,117763,0,0
2021-11-04,10050,,5113,39,,,0.0,7180832,0,6956513,117802,0,0
2021-11-05,9502,,6060,47,,,0.0,7190334,0,6962573,117849,0,0
2021-11-06,8998,,4852,26,,,0.0,7199332,0,6967425,117875,0,0
2021-11-07,9605,,3752,25,,,0.0,7208937,0,6971177,117900,0,0
2021-11-08,8547,,1032,10,,,0.0,7217484,0,6972209,117910,0,0
2021-11-09,2197,,5924,55,,,0.0,7219681,0,6978133,117965,0,0
2021-11-10,12476,,5981,58,,,0.0,7232157,0,6984114,118023,0,0
2021-11-11,11883,,6069,33,,,0.0,7244040,0,6990183,118056,0,0
2021-11-12,12603,,6333,17,,,0.0,7256643,0,6996516,118073,0,0
2021-11-13,3860,,6274,48,,,0.0,7260503,0,7002790,118121,0,0
2021-11-14,14646,,4957,16,,,0.0,7275149,0,7007747,118137,0,0
2021-11-15,12496,,1279,17,,,0.0,7287645,0,7009026,118154,0,0
2021-11-16,3241,,6586,70,,,0.0,7290886,0,7015612,118224,0,0
2021-11-17,19778,,6458,47,,,0.0,7310664,0,7022070,118271,0,0
2021-11-18,20294,,6414,50,,,0.0,7330958,0,7028484,118321,0,0
2021-11-19,20366,,6383,52,,,0.0,7351324,0,7034867,118373,0,0
2021-11-21,43898,,13587,73,,,0.0,7395222,0,7048454,118446,0,0
