date,today_confirm,today_suspect,today_heal,today_dead,today_severe,today_storeConfirm,today_input,total_confirm,total_suspect,total_heal,total_dead,total_severe,total_input
2020-02-08,8,0.0,0,0,,,,8,0,0,0,0,0
2020-02-12,1,0.0,0,0,,,0.0,9,0,0,0,0,0
2020-02-23,4,0.0,8,0,,,0.0,13,0,8,0,0,0
2020-02-27,3,0.0,0,0,,,0.0,16,0,8,0,0,0
2020-02-28,4,0.0,0,0,,,0.0,20,0,8,0,0,0
2020-02-29,3,0.0,0,0,,,0.0,23,0,8,0,0,0
2020-03-01,13,0.0,0,0,,,0.0,36,0,8,0,0,0
2020-03-02,4,0.0,0,0,,,0.0,40,0,8,0,0,0
2020-03-03,11,0.0,0,0,0.0,,0.0,51,0,8,0,0,0
2020-03-04,34,0.0,0,0,0.0,,0.0,85,0,8,0,0,0
2020-03-05,31,0.0,0,1,0.0,,0.0,116,0,8,1,0,0
2020-03-06,47,0.0,0,1,0.0,,0.0,163,0,8,2,0,0
2020-03-07,43,0.0,0,0,0.0,,0.0,206,0,8,2,0,0
2020-03-08,67,0.0,0,0,0.0,,0.0,273,0,8,2,0,0
2020-03-09,46,0.0,0,3,0.0,,0.0,319,0,8,5,0,0
2020-03-10,63,0.0,0,1,0.0,,0.0,382,0,8,6,0,0
2020-03-11,78,0.0,0,2,0.0,,0.0,460,0,8,8,0,0
2020-03-12,130,0.0,0,2,0.0,,0.0,590,0,8,10,0,0
2020-03-13,208,0.0,0,0,0.0,,0.0,798,0,8,10,0,0
2020-03-14,347,0.0,0,11,0.0,,0.0,1145,0,8,21,0,0
2020-03-15,227,0.0,0,14,0.0,,0.0,1372,0,8,35,0,0
2020-03-16,171,0.0,10,20,0.0,,0.0,1543,0,18,55,0,0
2020-03-17,407,0.0,0,16,0.0,,0.0,1950,0,18,71,0,0
2020-03-18,676,0.0,0,0,0.0,,0.0,2626,0,18,71,0,0
2020-03-19,643,0.0,0,73,0.0,,0.0,3269,0,18,144,0,0
2020-03-20,714,0.0,0,40,0.0,,0.0,3983,0,18,184,0,0
2020-03-21,1035,0.0,47,49,0.0,,0.0,5018,0,65,233,0,0
2020-03-22,665,0.0,0,48,0.0,,0.0,5683,0,65,281,0,0
2020-03-23,967,0.0,0,54,0.0,,0.0,6650,0,65,335,0,0
2020-03-24,1427,0.0,0,87,0.0,,0.0,8077,0,65,422,0,0
2020-03-25,1452,0.0,0,43,0.0,,0.0,9529,0,65,465,0,0
2020-03-26,2129,0.0,70,113,0.0,,0.0,11658,0,135,578,0,0
2020-03-27,2921,0.0,15,181,0.0,,0.0,14579,0,150,759,0,0
2020-03-28,2510,0.0,1,260,0.0,,0.0,17089,0,151,1019,0,0
2020-03-29,2433,0.0,0,209,0.0,,0.0,19522,0,151,1228,0,0
2020-03-30,2619,0.0,0,180,0.0,,0.0,22141,0,151,1408,0,0
2020-03-31,7833,0.0,28,385,0.0,,0.0,29974,0,179,1793,0,0
2020-04-01,519,0.0,0,559,0.0,,0.0,30493,0,179,2352,0,0
2020-04-02,3225,0.0,13,569,0.0,,0.0,33718,0,192,2921,0,0
2020-04-03,4450,0.0,0,684,0.0,,0.0,38168,0,192,3605,0,0
2020-04-04,4265,0.0,17,715,0.0,,0.0,42433,0,209,4320,0,0
2020-04-05,5955,,6,621,,,0.0,48388,0,215,4941,0,0
2020-04-06,63,,14,2,,,0.0,48451,0,229,4943,0,0
2020-04-07,3851,,83,442,,,0.0,52302,0,312,5385,0,0
2020-04-08,3655,,20,786,,,0.0,55957,0,332,6171,0,0
2020-04-09,5540,,21,940,,,0.0,61497,0,353,7111,0,0
2020-04-10,4375,,14,882,,,0.0,65872,0,367,7993,0,0
2020-04-11,13969,,232,1898,,,0.0,79841,0,599,9891,0,0
2020-04-12,4438,0.0,23,5,0.0,,0.0,84279,0,622,9896,0,0
2020-04-13,4342,0.0,0,1433,0.0,,0.0,88621,0,622,11329,0,0
2020-04-14,5252,0.0,0,778,0.0,,0.0,93873,0,622,12107,0,0
2020-04-15,5643,,0,787,,,0.0,99516,0,622,12894,0,0
2020-04-16,3577,,0,835,,,0.0,103093,0,622,13729,0,0
2020-04-17,5599,0.0,0,847,0.0,,0.0,108692,0,622,14576,0,0
2020-04-18,5525,,0,888,,,0.0,114217,0,622,15464,0,0
2020-04-19,5850,0.0,0,596,0.0,,0.0,120067,0,622,16060,0,0
2020-04-20,4676,0.0,0,449,0.0,,0.0,124743,0,622,16509,0,0
2020-04-21,4301,,0,828,,,0.0,129044,0,622,17337,0,0
2020-04-22,4451,,18,763,,,0.0,133495,0,640,18100,0,0
2020-04-23,4583,0.0,0,638,0.0,,0.0,138078,0,640,18738,0,0
2020-04-24,5386,,0,768,,,0.0,143464,0,640,19506,0,0
2020-04-25,4913,,0,813,,,0.0,148377,0,640,20319,0,0
2020-04-26,4463,,0,413,,,0.0,152840,0,640,20732,0,0
2020-04-27,4309,,0,360,,,0.0,157149,0,640,21092,0,0
2020-04-28,3996,,169,586,,,0.0,161145,0,809,21678,0,0
2020-04-29,4076,,4,4419,,,0.0,165221,0,813,26097,0,0
2020-04-30,6032,,0,674,,,0.0,171253,0,813,26771,0,0
2020-05-01,6201,0.0,79,739,0.0,,0.0,177454,0,892,27510,0,0
2020-05-02,4806,,4,621,,,0.0,182260,0,896,28131,0,0
2020-05-03,4299,,5,315,,,0.0,186559,0,901,28446,0,0
2020-05-04,4025,,9,288,,,0.0,190584,0,910,28734,0,0
2020-05-05,4406,,0,693,,,0.0,194990,0,910,29427,0,0
2020-05-06,6111,,19,649,,,0.0,201101,0,929,30076,0,0
2020-05-07,1258,,41,74,,,0.0,202359,0,970,30150,0,0
2020-05-08,5618,,27,539,,,0.0,207977,0,997,30689,0,0
2020-05-09,7283,,0,898,,,0.0,215260,0,997,31587,0,0
2020-05-10,3923,0.0,5,268,0.0,,0.0,219183,0,1002,31855,0,0
2020-05-11,3877,,916,210,,,0.0,223060,0,1918,32065,0,0
2020-05-12,3403,,0,627,,,0.0,226463,0,1918,32692,0,0
2020-05-13,3242,,0,494,,,0.0,229705,0,1918,33186,0,0
2020-05-14,3446,,0,428,,,0.0,233151,0,1918,33614,0,0
2020-05-15,3560,,0,384,,,0.0,236711,0,1918,33998,0,0
2020-05-16,3450,,0,468,,,0.0,240161,0,1918,34466,0,0
2020-05-17,3142,0.0,0,80,0.0,,0.0,243303,0,1918,34546,0,0
2020-05-18,3103,,0,250,,,0.0,246406,0,1918,34796,0,0
2020-05-19,2412,,0,545,,,0.0,248818,0,1918,35341,0,0
2020-05-20,1320,,0,363,,,0.0,250138,0,1918,35704,0,0
2020-05-21,770,,0,338,,,0.0,250908,0,1918,36042,0,0
2020-05-22,3287,,0,351,,,0.0,254195,0,1918,36393,0,0
2020-05-23,2959,,0,282,,,0.0,257154,0,1918,36675,0,0
2020-05-24,2405,,0,118,,,0.0,259559,0,1918,36793,0,0
2020-05-25,1625,0.0,0,121,0.0,,0.0,261184,0,1918,36914,0,0
2020-05-26,4043,,0,134,,,0.0,265227,0,1918,37048,0,0
2020-05-27,2013,,0,412,,,0.0,267240,0,1918,37460,0,0
2020-05-28,1887,,0,377,,,0.0,269127,0,1918,37837,0,0
2020-05-29,2095,,0,324,,,0.0,271222,0,1918,38161,0,0
2020-05-30,1604,,0,215,,,0.0,272826,0,1918,38376,0,0
2020-05-31,1936,,0,113,,,0.0,274762,0,1918,38489,0,0
2020-06-01,1570,,0,556,,,0.0,276332,0,1918,39045,0,0
2020-06-02,1653,,0,324,,,0.0,277985,0,1918,39369,0,0
2020-06-03,1871,,0,359,,,0.0,279856,0,1918,39728,0,0
2020-06-04,1805,0.0,0,176,0.0,,0.0,281661,0,1918,39904,0,0
2020-06-05,1650,,0,357,,,0.0,283311,0,1918,40261,0,0
2020-06-06,1557,,0,204,,,0.0,284868,0,1918,40465,0,0
2020-06-07,2753,,-679,160,,,0.0,287621,0,1239,40625,0,0
2020-06-08,0,,1,0,,,0.0,287621,0,1240,40625,0,0
2020-06-09,1213,,15,55,,,0.0,288834,0,1255,40680,0,0
2020-06-10,1747,,2,288,,,0.0,290581,0,1257,40968,0,0
2020-06-11,2273,,12,396,,,0.0,292854,0,1269,41364,0,0
2020-06-12,96,0.0,0,117,0.0,,0.0,292950,0,1269,41481,0,0
2020-06-13,1425,0.0,-14,181,0.0,,0.0,294375,0,1255,41662,0,0
2020-06-14,1514,0.0,28,36,0.0,,0.0,295889,0,1283,41698,0,0
2020-06-15,1453,,1,85,,,0.0,297342,0,1284,41783,0,0
2020-06-16,973,,0,38,,,0.0,298315,0,1284,41821,0,0
2020-06-17,1285,,11,233,,,0.0,299600,0,1295,42054,0,0
2020-06-18,1117,,9,184,,,0.0,300717,0,1304,42238,0,0
2020-06-19,2564,,9,308,,,0.0,303281,0,1313,42546,0,0
2020-06-20,2,,0,0,,,0.0,303283,0,1313,42546,0,0
2020-06-21,2518,,6,171,,,0.0,305801,0,1319,42717,0,0
2020-06-22,2,,0,0,,,0.0,305803,0,1319,42717,0,0
2020-06-23,958,,3,14,,,0.0,306761,0,1322,42731,0,0
2020-06-24,921,,8,280,,,0.0,307682,0,1330,43011,0,0
2020-06-25,655,,15,154,,,0.0,308337,0,1345,43165,0,0
2020-06-26,2499,,16,333,,,0.0,310836,0,1361,43498,0,0
2020-06-27,1,,2,0,,,0.0,310837,0,1363,43498,0,0
2020-06-28,1803,,1,136,,,0.0,312640,0,1364,43634,0,0
2020-06-29,827,,0,25,,,0.0,313467,0,1364,43659,0,0
2020-06-30,3,,3,0,,,0.0,313470,0,1367,43659,0,0
2020-07-01,692,,3,156,,,0.0,314162,0,1370,43815,0,0
2020-07-02,830,,2,176,,,0.0,314992,0,1372,43991,0,0
2020-07-03,0,,0,0,,,0.0,314992,0,1372,43991,0,0
2020-07-06,-27702,,3,330,,,0.0,287290,0,1375,44321,0,0
2020-07-07,1,,0,0,,,0.0,287291,0,1375,44321,0,0
2020-07-08,1219,,0,281,,,0.0,288510,0,1375,44602,0,0
2020-07-09,2,,3,0,,,0.0,288512,0,1378,44602,0,0
2020-07-10,4503,,0,133,,,0.0,293015,0,1378,44735,0,0
2020-07-11,-3336,,0,0,,,0.0,289679,0,1378,44735,0,0
2020-07-12,825,,0,148,,,0.0,290504,0,1378,44883,0,0
2020-07-13,651,,0,21,,,0.0,291155,0,1378,44904,0,0
2020-07-14,536,,6,11,,,0.0,291691,0,1384,44915,0,0
2020-07-15,1240,,2,138,,,0.0,292931,0,1386,45053,0,0
2020-07-16,538,,0,85,,,0.0,293469,0,1386,45138,0,0
2020-07-17,647,,17,66,,,0.0,294116,0,1403,45204,0,0
2020-07-18,688,,0,114,,,0.0,294804,0,1403,45318,0,0
2020-07-19,828,,10,40,,,0.0,295632,0,1413,45358,0,0
2020-07-20,732,,0,27,,,0.0,296364,0,1413,45385,0,0
2020-07-21,580,,0,12,,,0.0,296944,0,1413,45397,0,0
2020-07-22,447,,1,110,,,0.0,297391,0,1414,45507,0,0
2020-07-23,561,,2,79,,,0.0,297952,0,1416,45586,0,0
2020-07-24,779,,9,53,,,0.0,298731,0,1425,45639,0,0
2020-07-25,1539,,2,184,,,0.0,300270,0,1427,45823,0,0
2020-07-26,5,,7,0,,,0.0,300275,0,1434,45823,0,0
2020-07-27,745,,0,14,,,0.0,301020,0,1434,45837,0,0
2020-07-28,689,,3,7,,,0.0,301709,0,1437,45844,0,0
2020-07-29,1383,,1,202,,,0.0,303092,0,1438,46046,0,0
2020-07-30,-28,,0,0,,,0.0,303064,0,1438,46046,0,0
2020-07-31,849,,1,38,,,0.0,303913,0,1439,46084,0,0
2020-08-01,1659,,2,194,,,0.0,305572,0,1441,46278,0,0
2020-08-02,743,,1,8,,,0.0,306315,0,1442,46286,0,0
2020-08-03,4,,2,0,,,0.0,306319,0,1444,46286,0,0
2020-08-04,933,,1,9,,,0.0,307252,0,1445,46295,0,0
2020-08-05,6,,0,0,,,0.0,307258,0,1445,46295,0,0
2020-08-06,14,,2,0,,,0.0,307272,0,1447,46295,0,0
2020-08-07,2524,,0,203,,,0.0,309796,0,1447,46498,0,0
2020-08-08,907,,1,98,,,0.0,310703,0,1448,46596,0,0
2020-08-09,785,,1,55,,,0.0,311488,0,1449,46651,0,0
2020-08-10,1086,,2,8,,,0.0,312574,0,1451,46659,0,0
2020-08-11,818,,12,-48,,,0.0,313392,0,1463,46611,0,0
2020-08-12,2168,,2,180,,,0.0,315560,0,1465,46791,0,0
2020-08-13,23,,8,0,,,0.0,315583,0,1473,46791,0,0
2020-08-14,17,,6,0,,,0.0,315600,0,1479,46791,0,0
2020-08-15,2593,,4,0,,,0.0,318193,0,1483,46791,0,0
2020-08-16,1045,,3,0,,,0.0,319238,0,1486,46791,0,0
2020-08-17,1107,,4,0,,,0.0,320345,0,1490,46791,0,0
2020-08-18,726,,2,-5337,,,0.0,321071,0,1492,41454,0,0
2020-08-19,1919,,3,28,,,0.0,322990,0,1495,41482,0,0
2020-08-20,18,,0,1,,,0.0,323008,0,1495,41483,0,0
2020-08-21,1188,,3,6,,,0.0,324196,0,1498,41489,0,0
2020-08-22,1044,,46,2,,,0.0,325240,0,1544,41491,0,0
2020-08-23,2396,,3,24,,,0.0,327636,0,1547,41515,0,0
2020-08-24,9,,2,0,,,0.0,327645,0,1549,41515,0,0
2020-08-25,983,,1,4,,,0.0,328628,0,1550,41519,0,0
2020-08-26,1255,,1,16,,,0.0,329883,0,1551,41535,0,0
2020-08-27,2608,,13,29,,,0.0,332491,0,1564,41564,0,0
2020-08-28,20,,5,0,,,0.0,332511,0,1569,41564,0,0
2020-08-29,2404,,51,21,,,0.0,334915,0,1620,41585,0,0
2020-08-30,1726,,4,1,,,0.0,336641,0,1624,41586,0,0
2020-08-31,32,,56,0,,,0.0,336673,0,1680,41586,0,0
2020-09-01,1412,,7,3,,,0.0,338085,0,1687,41589,0,0
2020-09-02,1335,,25,3,,,0.0,339420,0,1712,41592,0,0
2020-09-03,3264,,38,23,,,0.0,342684,0,1750,41615,0,0
2020-09-04,31,,2,1,,,0.0,342715,0,1752,41616,0,0
2020-09-05,1978,,11,10,,,0.0,344693,0,1763,41626,0,0
2020-09-06,4811,,61,14,,,0.0,349504,0,1824,41640,0,0
2020-09-07,2944,,0,3,,,0.0,352448,0,1824,41643,0,0
2020-09-08,2428,,3,30,,,0.0,354876,0,1827,41673,0,0
2020-09-09,58,,1,2,,,0.0,354934,0,1828,41675,0,0
2020-09-10,2680,,13,8,,,0.0,357614,0,1841,41683,0,0
2020-09-11,2930,,6,14,,,0.0,360544,0,1847,41697,0,0
2020-09-12,7046,,26,15,,,0.0,367590,0,1873,41712,0,0
2020-09-13,3338,,17,5,,,0.0,370928,0,1890,41717,0,0
2020-09-14,2,,262,0,,,0.0,370930,0,2152,41717,0,0
2020-09-15,2629,,4,9,,,0.0,373559,0,2156,41726,0,0
2020-09-16,3117,,30,27,,,0.0,376676,0,2186,41753,0,0
2020-09-17,4004,,8,20,,,0.0,380680,0,2194,41773,0,0
2020-09-18,3410,,9,21,,,0.0,384090,0,2203,41794,0,0
2020-09-19,4330,,17,27,,,0.0,388420,0,2220,41821,0,0
2020-09-20,4425,,8,27,,,0.0,392845,0,2228,41848,0,0
2020-09-21,3899,,0,18,,,0.0,396744,0,2228,41866,0,0
2020-09-22,4383,,0,11,,,0.0,401127,0,2228,41877,0,0
2020-09-23,4933,,11,37,,,0.0,406060,0,2239,41914,0,0
2020-09-24,6189,,15,37,,,0.0,412249,0,2254,41951,0,0
2020-09-25,13516,,30,40,,,0.0,425765,0,2284,41991,0,0
2020-09-26,6051,,46,69,,,0.0,431816,0,2330,42060,0,0
2020-09-27,8,,9,0,,,0.0,431824,0,2339,42060,0,0
2020-09-28,5696,,0,17,,,0.0,437520,0,2339,42077,0,0
2020-09-29,4062,,14,13,,,0.0,441582,0,2353,42090,0,0
2020-09-30,7152,,17,72,,,0.0,448734,0,2370,42162,0,0
2020-10-01,7126,,8,71,,,0.0,455860,0,2378,42233,0,0
2020-10-02,6921,,7,125,,,0.0,462781,0,2385,42358,0,0
2020-10-03,7000,,11,0,,,0.0,469781,0,2396,42358,0,0
2020-10-04,12877,,2,49,,,0.0,482658,0,2398,42407,0,0
2020-10-05,22961,,8,33,,,0.0,505619,0,2406,42440,0,0
2020-10-06,12608,,8,19,,,0.0,518227,0,2414,42459,0,0
2020-10-07,14560,,11,76,,,0.0,532787,0,2425,42535,0,0
2020-10-08,14172,,10,70,,,0.0,546959,0,2435,42605,0,0
2020-10-09,17559,,51,77,,,0.0,564518,0,2486,42682,0,0
2020-10-10,13880,,9,87,,,0.0,578398,0,2495,42769,0,0
2020-10-11,15176,,8,146,,,0.0,593574,0,2503,42915,0,0
2020-10-12,12874,,6,50,,,0.0,606448,0,2509,42965,0,0
2020-10-13,14023,,8,0,,,0.0,620471,0,2517,42965,0,0
2020-10-14,17254,,29,143,,,0.0,637725,0,2546,43108,0,0
2020-10-15,19749,,9,137,,,0.0,657474,0,2555,43245,0,0
2020-10-16,18994,,8,138,,,0.0,676468,0,2563,43383,0,0
2020-10-17,15658,,10,286,,,0.0,692126,0,2573,43669,0,0
2020-10-18,16185,,5,0,,,0.0,708311,0,2578,43669,0,0
2020-10-19,35790,,18,67,,,0.0,744101,0,2596,43736,0,0
2020-10-20,21,,17,80,,,0.0,744122,0,2613,43816,0,0
2020-10-21,21378,,23,241,,,0.0,765500,0,2636,44057,0,0
2020-10-22,26712,,14,191,,,0.0,792212,0,2650,44248,0,0
2020-10-23,21253,,7,189,,,0.0,813465,0,2657,44437,0,0
2020-10-24,20564,,7,224,,,0.0,834029,0,2664,44661,0,0
2020-10-25,23021,,21,174,,,0.0,857050,0,2685,44835,0,0
2020-10-26,19794,,16,151,,,0.0,876844,0,2701,44986,0,0
2020-10-27,20922,,1,102,,,0.0,897766,0,2702,45088,0,0
2020-10-28,22901,,32,367,,,0.0,920667,0,2734,45455,0,0
2020-10-29,24717,,64,310,,,0.0,945384,0,2798,45765,0,0
2020-10-30,23077,,7,280,,,0.0,968461,0,2805,46045,0,0
2020-10-31,24417,,34,274,,,0.0,992878,0,2839,46319,0,0
2020-11-01,21922,,2,326,,,0.0,1014800,0,2841,46645,0,0
2020-11-02,23262,,9,162,,,0.0,1038062,0,2850,46807,0,0
2020-11-03,18959,,0,136,,,0.0,1057021,0,2850,46943,0,0
2020-11-04,20091,,68,397,,,0.0,1077112,0,2918,47340,0,0
2020-11-05,25204,,13,492,,,0.0,1102316,0,2931,47832,0,0
2020-11-06,24169,,18,378,,,0.0,1126485,0,2949,48210,0,0
2020-11-07,23323,,13,355,,,0.0,1149808,0,2962,48565,0,0
2020-11-08,24970,,6,413,,,0.0,1174778,0,2968,48978,0,0
2020-11-09,20584,,22,156,,,0.0,1195362,0,2990,49134,0,0
2020-11-10,21385,,8,195,,,0.0,1216747,0,2998,49329,0,0
2020-11-11,20451,,10,532,,,0.0,1237198,0,3008,49861,0,0
2020-11-12,23022,,17,596,,,0.0,1260220,0,3025,50457,0,0
2020-11-13,33508,,16,563,,,0.0,1293728,0,3041,51020,0,0
2020-11-14,27314,,61,376,,,0.0,1321042,0,3102,51396,0,0
2020-11-15,26880,,18,462,,,0.0,1347922,0,3120,51858,0,0
2020-11-16,24967,,15,168,,,0.0,1372889,0,3135,52026,0,0
2020-11-17,21410,,0,214,,,0.0,1394299,0,3135,52240,0,0
2020-11-18,20072,,47,599,,,0.0,1414371,0,3182,52839,0,0
2020-11-19,19633,,24,530,,,0.0,1434004,0,3206,53369,0,0
2020-11-20,22954,,54,501,,,0.0,1456958,0,3260,53870,0,0
2020-11-21,20282,,32,511,,,0.0,1477240,0,3292,54381,0,0
2020-11-22,19900,,30,341,,,0.0,1497140,0,3322,54722,0,0
2020-11-23,18672,,11,399,,,0.0,1515812,0,3333,55121,0,0
2020-11-24,15469,,14,206,,,0.0,1531281,0,3347,55327,0,0
2020-11-25,11352,,73,608,,,0.0,1542633,0,3420,55935,0,0
2020-11-26,18239,,33,695,,,0.0,1560872,0,3453,56630,0,0
2020-11-27,17565,,3,498,,,0.0,1578437,0,3456,57128,0,0
2020-11-28,14823,,21,520,,,0.0,1593260,0,3477,57648,0,0
2020-11-29,15890,,37,479,,,0.0,1609150,0,3514,58127,0,0
2020-11-30,12163,,7,215,,,0.0,1621313,0,3521,58342,0,0
2020-12-01,12421,,50,203,,,0.0,1633734,0,3571,58545,0,0
2020-12-02,13496,,18,603,,,0.0,1647230,0,3589,59148,0,0
2020-12-03,16241,,32,648,,,0.0,1663471,0,3621,59796,0,0
2020-12-04,14952,,11,414,,,0.0,1678423,0,3632,60210,0,0
2020-12-05,16383,,16,504,,,0.0,1694806,0,3648,60714,0,0
2020-12-06,15578,,12,397,,,0.0,1710384,0,3660,61111,0,0
2020-12-07,17371,,76,231,,,0.0,1727755,0,3736,61342,0,0
2020-12-08,14773,,25,189,,,0.0,1742528,0,3761,61531,0,0
2020-12-09,12390,,9,599,,,0.0,1754918,0,3770,62130,0,0
2020-12-10,16637,,9,533,,,0.0,1771555,0,3779,62663,0,0
2020-12-11,21057,,15,516,,,0.0,1792612,0,3794,63179,0,0
2020-12-12,21785,,11,424,,,0.0,1814397,0,3805,63603,0,0
2020-12-13,21555,,4,520,,,0.0,1835952,0,3809,64123,0,0
2020-12-14,18538,,204,144,,,0.0,1854490,0,4013,64267,0,0
2020-12-15,20377,,35,233,,,0.0,1874867,0,4048,64500,0,0
2020-12-16,18580,,48,506,,,0.0,1893447,0,4096,65006,0,0
2020-12-17,25321,,15,612,,,0.0,1918768,0,4111,65618,0,0
2020-12-18,35543,,22,532,,,0.0,1954311,0,4133,66150,0,0
2020-12-19,28706,,207,493,,,0.0,1983017,0,4340,66643,0,0
2020-12-20,27104,,30,534,,,0.0,2010121,0,4370,67177,0,0
2020-12-21,36040,,5,326,,,0.0,2046161,0,4375,67503,0,0
2020-12-22,33565,,17,215,,,0.0,2079726,0,4392,67718,0,0
2020-12-23,36883,,222,694,,,0.0,2116609,0,4614,68412,0,0
2020-12-24,39468,,109,745,,,0.0,2156077,0,4723,69157,0,0
2020-12-25,39144,,99,575,,,0.0,2195221,0,4822,69732,0,0
2020-12-26,32800,,32,570,,,0.0,2228021,0,4854,70302,0,0
2020-12-27,34714,,56,211,,,0.0,2262735,0,4910,70513,0,0
2020-12-28,32538,,190,347,,,0.0,2295273,0,5100,70860,0,0
2020-12-29,41518,,29,357,,,0.0,2336791,0,5129,71217,0,0
2020-12-30,53352,,205,458,,,0.0,2390143,0,5334,71675,0,0
2020-12-31,50059,,80,982,,,0.0,2440202,0,5414,72657,0,0
2021-01-01,56029,,65,965,,,0.0,2496231,0,5479,73622,0,0
2021-01-02,53550,,225,615,,,0.0,2549781,0,5704,74237,0,0
2021-01-03,112753,,41,899,,,0.0,2662534,0,5745,75136,0,0
2021-01-04,272,,400,1,,,0.0,2662806,0,6145,75137,0,0
2021-01-05,58816,,115,410,,,0.0,2721622,0,6260,75547,0,0
2021-01-06,61087,,123,881,,,0.0,2782709,0,6383,76428,0,0
2021-01-07,62560,,74,1042,,,0.0,2845269,0,6457,77470,0,0
2021-01-08,52788,,70,1163,,,0.0,2898057,0,6527,78633,0,0
2021-01-09,68280,,323,1332,,,0.0,2966337,0,6850,79965,0,0
2021-01-10,60011,,12,1035,,,0.0,3026348,0,6862,81000,0,0
2021-01-11,55020,,147,567,,,0.0,3081368,0,7009,81567,0,0
2021-01-12,46275,,140,529,,,0.0,3127643,0,7149,82096,0,0
2021-01-13,45656,,203,1246,,,0.0,3173299,0,7352,83342,0,0
2021-01-14,47657,,86,1568,,,0.0,3220956,0,7438,84910,0,0
2021-01-15,48804,,147,1253,,,0.0,3269760,0,7585,86163,0,0
2021-01-16,55885,,118,1289,,,0.0,3325645,0,7703,87452,0,0
2021-01-17,41425,,159,1295,,,0.0,3367070,0,7862,88747,0,0
2021-01-18,38670,,180,682,,,0.0,3405740,0,8042,89429,0,0
2021-01-19,37691,,278,604,,,0.0,3443431,0,8320,90033,0,0
2021-01-20,33396,,74,1610,,,0.0,3476827,0,8394,91643,0,0
2021-01-21,39008,,102,1826,,,0.0,3515835,0,8496,93469,0,0
2021-01-22,37967,,104,1296,,,0.0,3553802,0,8600,94765,0,0
2021-01-23,40343,,84,1401,,,0.0,3594145,0,8684,96166,0,0
2021-01-24,33644,,180,1352,,,0.0,3627789,0,8864,97518,0,0
2021-01-25,30094,,155,613,,,0.0,3657883,0,9019,98131,0,0
2021-01-26,22219,,17,592,,,0.0,3680102,0,9036,98723,0,0
2021-01-27,20166,,124,1636,,,0.0,3700268,0,9160,100359,0,0
2021-01-28,25445,,117,1726,,,0.0,3725713,0,9277,102085,0,0
2021-01-29,28785,,73,1239,,,0.0,3754498,0,9350,103324,0,0
2021-01-30,29095,,54,1248,,,0.0,3783593,0,9404,104572,0,0
2021-01-31,23400,,176,1205,,,0.0,3806993,0,9580,105777,0,0
2021-02-01,21190,,72,590,,,0.0,3828183,0,9652,106367,0,0
2021-02-02,18668,,83,407,,,0.0,3846851,0,9735,106774,0,0
2021-02-03,16906,,83,1451,,,0.0,3863757,0,9818,108225,0,0
2021-02-04,19215,,118,1322,,,0.0,3882972,0,9936,109547,0,0
2021-02-05,20734,,75,915,,,0.0,3903706,0,10011,110462,0,0
2021-02-06,19204,,83,1015,,,0.0,3922910,0,10094,111477,0,0
2021-02-07,18363,,88,828,,,0.0,3941273,0,10182,112305,0,0
2021-02-08,15909,,114,376,,,0.0,3957182,0,10296,112681,0,0
2021-02-09,14137,,48,333,,,0.0,3971319,0,10344,113014,0,0
2021-02-10,12437,,83,1052,,,0.0,3983756,0,10427,114066,0,0
2021-02-11,13083,,79,1004,,,0.0,3996839,0,10506,115070,0,0
2021-02-12,13537,,94,678,,,0.0,4010376,0,10600,115748,0,0
2021-02-13,15201,,77,759,,,0.0,4025577,0,10677,116507,0,0
2021-02-14,13356,,183,621,,,0.0,4038933,0,10860,117128,0,0
2021-02-15,10991,,59,262,,,0.0,4049924,0,10919,117390,0,0
2021-02-16,9772,,40,232,,,0.0,4059696,0,10959,117622,0,0
2021-02-17,10638,,73,799,,,0.0,4070334,0,11032,118421,0,0
2021-02-18,12758,,67,738,,,0.0,4083092,0,11099,119159,0,0
2021-02-19,12095,,61,455,,,0.0,4095187,0,11160,119614,0,0
2021-02-20,12099,,94,533,,,0.0,4107286,0,11254,120147,0,0
2021-02-21,10453,,44,448,,,0.0,4117739,0,11298,120595,0,0
2021-02-22,9835,,13,215,,,0.0,4127574,0,11311,120810,0,0
2021-02-23,10659,,31,178,,,0.0,4138233,0,11342,120988,0,0
2021-02-24,8523,,111,548,,,0.0,4146756,0,11453,121536,0,0
2021-02-25,9970,,44,443,,,0.0,4156726,0,11497,121979,0,0
2021-02-26,10021,,38,324,,,0.0,4166747,0,11535,122303,0,0
2021-02-27,8571,,44,346,,,0.0,4175318,0,11579,122649,0,0
2021-02-28,7470,,28,290,,,0.0,4182788,0,11607,122939,0,0
2021-03-01,6039,,37,144,,,0.0,4188827,0,11644,123083,0,0
2021-03-02,5468,,2,104,,,0.0,4194295,0,11646,123187,0,0
2021-03-03,6422,,80,343,,,0.0,4200717,0,11726,123530,0,0
2021-03-04,6408,,18,487,,,0.0,4207125,0,11744,124017,0,0
2021-03-05,6640,,54,242,,,0.0,4213765,0,11798,124259,0,0
2021-03-06,6026,,38,236,,,0.0,4219791,0,11836,124495,0,0
2021-03-07,6115,,13,159,,,0.0,4225906,0,11849,124654,0,0
2021-03-08,5260,,2,82,,,0.0,4231166,0,11851,124736,0,0
2021-03-09,4829,,4,65,,,0.0,4235995,0,11855,124801,0,0
2021-03-10,5863,,13,231,,,0.0,4241858,0,11868,125032,0,0
2021-03-11,6021,,55,190,,,0.0,4247879,0,11923,125222,0,0
2021-03-12,6835,,21,181,,,0.0,4254714,0,11944,125403,0,0
2021-03-13,6684,,5,177,,,0.0,4261398,0,11949,125580,0,0
2021-03-14,5617,,17,121,,,0.0,4267015,0,11966,125701,0,0
2021-03-15,4695,,6,52,,,0.0,4271710,0,11972,125753,0,0
2021-03-16,5130,,25,64,,,0.0,4276840,0,11997,125817,0,0
2021-03-17,5363,,16,110,,,0.0,4282203,0,12013,125927,0,0
2021-03-18,5793,,45,141,,,0.0,4287996,0,12058,126068,0,0
2021-03-19,6353,,37,95,,,0.0,4294349,0,12095,126163,0,0
2021-03-20,4867,,41,100,,,0.0,4299216,0,12136,126263,0,0
2021-03-21,5643,,34,97,,,0.0,4304859,0,12170,126360,0,0
2021-03-22,5336,,6,33,,,0.0,4310195,0,12176,126393,0,0
2021-03-23,5408,,57,18,,,0.0,4315603,0,12233,126411,0,0
2021-03-24,5416,,150,112,,,0.0,4321019,0,12383,126523,0,0
2021-03-25,5666,,22,98,,,0.0,4326685,0,12405,126621,0,0
2021-03-26,6274,,162,63,,,0.0,4332959,0,12567,126684,0,0
2021-03-27,6205,,15,71,,,0.0,4339164,0,12582,126755,0,0
2021-03-28,3984,,135,58,,,0.0,4343148,0,12717,126813,0,0
2021-03-29,3866,,59,21,,,0.0,4347014,0,12776,126834,0,0
2021-03-30,0,,0,0,,,0.0,4347014,0,12776,126834,0,0
2021-03-31,8853,,177,78,,,0.0,4355867,0,12953,126912,0,0
2021-04-01,4118,,121,43,,,0.0,4359985,0,13074,126955,0,0
2021-04-02,4562,,16,51,,,0.0,4364547,0,13090,127006,0,0
2021-04-03,6845,,100,62,,,0.0,4371392,0,13190,127068,0,0
2021-04-04,109,,48,0,,,0.0,4371501,0,13238,127068,0,0
2021-04-05,2297,,17,10,,,0.0,4373798,0,13255,127078,0,0
2021-04-06,5210,,41,48,,,0.0,4379008,0,13296,127126,0,0
2021-04-07,53,,68,0,,,0.0,4379061,0,13364,127126,0,0
2021-04-08,2858,,49,45,,,0.0,4381919,0,13413,127171,0,0
2021-04-09,3106,,54,53,,,0.0,4385025,0,13467,127224,0,0
2021-04-10,-4858,,0,60,,,0.0,4380167,0,13467,127284,0,0
2021-04-11,2713,,27,40,,,0.0,4382880,0,13494,127324,0,0
2021-04-12,1730,,1,7,,,0.0,4384610,0,13495,127331,0,0
2021-04-13,3707,,152,15,,,0.0,4388317,0,13647,127346,0,0
2021-04-14,4975,,13,61,,,0.0,4393292,0,13660,127407,0,0
2021-04-15,45,,15,0,,,0.0,4393337,0,13675,127407,0,0
2021-04-16,2769,,202,31,,,0.0,4396106,0,13877,127438,0,0
2021-04-17,2801,,63,34,,,0.0,4398907,0,13940,127472,0,0
2021-04-18,4151,,43,46,,,0.0,4403058,0,13983,127518,0,0
2021-04-19,2,,4,0,,,0.0,4403060,0,13987,127518,0,0
2021-04-20,3054,,53,6,,,0.0,4406114,0,14040,127524,0,0
2021-04-21,4938,,37,33,,,0.0,4411052,0,14077,127557,0,0
2021-04-22,52,,116,22,,,0.0,4411104,0,14193,127579,0,0
2021-04-23,2730,,2,18,,,0.0,4413834,0,14195,127597,0,0
2021-04-24,2814,,193,41,,,0.0,4416648,0,14388,127638,0,0
2021-04-25,2082,,64,32,,,0.0,4418730,0,14452,127670,0,0
2021-04-26,1728,,0,11,,,0.0,4420458,0,14452,127681,0,0
2021-04-27,2104,,100,7,,,0.0,4422562,0,14552,127688,0,0
2021-04-28,4866,,23,46,,,0.0,4427428,0,14575,127734,0,0
2021-04-29,-32,,45,0,,,0.0,4427396,0,14620,127734,0,0
2021-04-30,4838,,39,40,,,0.0,4432234,0,14659,127774,0,0
2021-05-01,1921,,25,8,,,0.0,4434155,0,14684,127782,0,0
2021-05-02,5,,0,0,,,0.0,4434160,0,14684,127782,0,0
2021-05-03,1674,,0,14,,,0.0,4435834,0,14684,127796,0,0
2021-05-04,1700,,146,3,,,0.0,4437534,0,14830,127799,0,0
2021-05-05,1960,,23,4,,,0.0,4439494,0,14853,127803,0,0
2021-05-06,2150,,44,27,,,0.0,4441644,0,14897,127830,0,0
2021-05-07,5108,,64,28,,,0.0,4446752,0,14961,127858,0,0
2021-05-08,-15709,,4227231,-260,,,0.0,4431043,0,4242192,127598,0,0
2021-05-09,17765,,-4227181,265,,,0.0,4448808,0,15011,127863,0,0
2021-05-10,1770,,0,2,,,0.0,4450578,0,15011,127865,0,0
2021-05-11,2388,,117,5,,,0.0,4452966,0,15128,127870,0,0
2021-05-12,2480,,21,20,,,0.0,4455446,0,15149,127890,0,0
2021-05-13,2302,,52,11,,,0.0,4457748,0,15201,127901,0,0
2021-05-14,2658,,12,12,,,0.0,4460406,0,15213,127913,0,0
2021-05-15,4228,,23,24,,,0.0,4464634,0,15236,127937,0,0
2021-05-16,29,,21,0,,,0.0,4464663,0,15257,127937,0,0
2021-05-17,1926,,1,4,,,0.0,4466589,0,15258,127941,0,0
2021-05-18,1993,,34,5,,,0.0,4468582,0,15292,127946,0,0
2021-05-19,-2362,,27,7,,,0.0,4466220,0,15319,127953,0,0
2021-05-20,2147,,33,3,,,0.0,4468367,0,15352,127956,0,0
2021-05-21,5400,,55,16,,,0.0,4473767,0,15407,127972,0,0
2021-05-22,7,,20,0,,,0.0,4473774,0,15427,127972,0,0
2021-05-23,2524,,0,6,,,0.0,4476298,0,15427,127978,0,0
2021-05-24,4454,,0,8,,,0.0,4480752,0,15427,127986,0,0
2021-05-25,11,,18,0,,,0.0,4480763,0,15445,127986,0,0
2021-05-26,2414,,8,15,,,0.0,4483177,0,15453,128001,0,0
2021-05-27,2991,,26,9,,,0.0,4486168,0,15479,128010,0,0
2021-05-28,3385,,1,10,,,0.0,4489553,0,15480,128020,0,0
2021-05-29,7270,,1,17,,,0.0,4496823,0,15481,128037,0,0
2021-05-30,0,,5,0,,,0.0,4496823,0,15486,128037,0,0
2021-05-31,3118,,1,6,,,0.0,4499941,0,15487,128043,0,0
2021-06-01,3291,,20,2,,,0.0,4503232,0,15507,128045,0,0
2021-06-02,3103,,2,0,,,0.0,4506335,0,15509,128045,0,0
2021-06-03,4263,,5,12,,,0.0,4510598,0,15514,128057,0,0
2021-06-04,5181,,3,18,,,0.0,4515779,0,15517,128075,0,0
2021-06-05,6143,,7,11,,,0.0,4521922,0,15524,128086,0,0
2021-06-06,5655,,7,13,,,0.0,4527577,0,15531,128099,0,0
2021-06-07,5225,,3,4,,,0.0,4532802,0,15534,128103,0,0
2021-06-08,5597,,4,1,,,0.0,4538399,0,15538,128104,0,0
2021-06-09,5975,,1,14,,,0.0,4544374,0,15539,128118,0,0
2021-06-10,7320,,1,6,,,0.0,4551694,0,15540,128124,0,0
2021-06-11,7239,,3,7,,,0.0,4558933,0,15543,128131,0,0
2021-06-12,7960,,0,17,,,0.0,4566893,0,15543,128148,0,0
2021-06-13,7554,,3,12,,,0.0,4574447,0,15546,128160,0,0
2021-06-14,7332,,7,8,,,0.0,4581779,0,15553,128168,0,0
2021-06-15,7621,,9,3,,,0.0,4589400,0,15562,128171,0,0
2021-06-16,7594,,0,10,,,0.0,4596994,0,15562,128181,0,0
2021-06-17,8813,,1,9,,,0.0,4605807,0,15563,128190,0,0
2021-06-18,10822,,38,19,,,0.0,4616629,0,15601,128209,0,0
2021-06-19,10286,,6,11,,,0.0,4626915,0,15607,128220,0,0
2021-06-20,10078,,3,14,,,0.0,4636993,0,15610,128234,0,0
2021-06-21,9075,,2,6,,,0.0,4646068,0,15612,128240,0,0
2021-06-22,10470,,3,5,,,0.0,4656538,0,15615,128245,0,0
2021-06-23,11505,,1,27,,,0.0,4668043,0,15616,128272,0,0
2021-06-24,15946,,89,19,,,0.0,4683989,0,15705,128291,0,0
2021-06-25,16705,,8,21,,,0.0,4700694,0,15713,128312,0,0
2021-06-26,15372,,5,18,,,0.0,4716066,0,15718,128330,0,0
2021-06-27,17945,,0,23,,,0.0,4734011,0,15718,128353,0,0
2021-06-28,14634,,6,11,,,0.0,4748645,0,15724,128364,0,0
2021-06-29,22724,,8,3,,,0.0,4771369,0,15732,128367,0,0
2021-06-30,20259,,2,23,,,0.0,4791628,0,15734,128390,0,0
2021-07-01,25688,,11,14,,,0.0,4817316,0,15745,128404,0,0
2021-07-02,27713,,9,22,,,0.0,4845029,0,15754,128426,0,0
2021-07-03,26789,,6,27,,,0.0,4871818,0,15760,128453,0,0
2021-07-04,24456,,13,18,,,0.0,4896274,0,15773,128471,0,0
2021-07-05,23900,,4,15,,,0.0,4920174,0,15777,128486,0,0
2021-07-06,27112,,0,9,,,0.0,4947286,0,15777,128495,0,0
2021-07-07,28630,,93,37,,,0.0,4975916,0,15870,128532,0,0
2021-07-08,32050,,0,33,,,0.0,5007966,0,15870,128565,0,0
2021-07-09,32447,,18,36,,,0.0,5040413,0,15888,128601,0,0
2021-07-10,35554,,4,30,,,0.0,5075967,0,15892,128631,0,0
2021-07-11,31836,,2,34,,,0.0,5107803,0,15894,128665,0,0
2021-07-12,31366,,9,26,,,0.0,5139169,0,15903,128691,0,0
2021-07-13,34826,,100,6,,,0.0,5173995,0,16003,128697,0,0
2021-07-14,36621,,4,51,,,0.0,5210616,0,16007,128748,0,0
2021-07-15,42075,,126,49,,,0.0,5252691,0,16133,128797,0,0
2021-07-16,48644,,8,67,,,0.0,5301335,0,16141,128864,0,0
2021-07-17,51972,,121,53,,,0.0,5353307,0,16262,128917,0,0
2021-07-18,54130,,168,43,,,0.0,5407437,0,16430,128960,0,0
2021-07-19,47872,,13,28,,,0.0,5455309,0,16443,128988,0,0
2021-07-20,40681,,47,19,,,0.0,5495990,0,16490,129007,0,0
2021-07-21,46869,,386,102,,,0.0,5542859,0,16876,129109,0,0
2021-07-22,43881,,174,73,,,0.0,5586740,0,17050,129182,0,0
2021-07-23,40032,,240,84,,,0.0,5626772,0,17290,129266,0,0
2021-07-24,36066,,160,64,,,0.0,5662838,0,17450,129330,0,0
2021-07-25,31624,,766,88,,,0.0,5694462,0,18216,129418,0,0
2021-07-26,28960,,29,28,,,0.0,5723422,0,18245,129446,0,0
2021-07-27,24913,,304,14,,,0.0,5748335,0,18549,129460,0,0
2021-07-28,23532,,972,131,,,0.0,5771867,0,19521,129591,0,0
2021-07-29,25584,,208,127,,,0.0,5797451,0,19729,129718,0,0
2021-07-30,30892,,909,91,,,0.0,5828343,0,20638,129809,0,0
2021-07-31,29318,,284,68,,,0.0,5857661,0,20922,129877,0,0
2021-08-01,25790,,153,72,,,0.0,5883451,0,21075,129949,0,0
2021-08-02,24163,,29,65,,,0.0,5907614,0,21104,130014,0,0
2021-08-03,22298,,1538,25,,,0.0,5929912,0,22642,130039,0,0
2021-08-04,21849,,1753,140,,,0.0,5951761,0,24395,130179,0,0
2021-08-05,29159,,297,121,,,0.0,5980920,0,24692,130300,0,0
2021-08-06,29928,,0,89,,,0.0,6010848,0,24692,130389,0,0
2021-08-07,31502,,0,93,,,0.0,6042350,0,24692,130482,0,0
2021-08-08,200,,0,0,,,0.0,6042550,0,24692,130482,0,0
2021-08-09,55576,,0,148,,,0.0,6098126,0,24692,130630,0,0
2021-08-10,25065,,0,37,,,0.0,6123191,0,24692,130667,0,0
2021-08-11,23468,,0,146,,,0.0,6146659,0,24692,130813,0,0
2021-08-12,29380,,0,108,,,0.0,6176039,0,24692,130921,0,0
2021-08-13,32869,,0,95,,,0.0,6208908,0,24692,131016,0,0
2021-08-14,0,,0,0,,,0.0,6208908,0,24692,131016,0,0
2021-08-15,61773,,0,194,,,0.0,6270681,0,24692,131210,0,0
2021-08-16,26476,,0,59,,,0.0,6297157,0,24692,131269,0,0
2021-08-17,28373,,0,27,,,0.0,6325530,0,24692,131296,0,0
2021-08-18,26759,,0,170,,,0.0,6352289,0,24692,131466,0,0
2021-08-19,33730,,0,111,,,0.0,6386019,0,24692,131577,0,0
2021-08-20,36519,,0,114,,,0.0,6422538,0,24692,131691,0,0
2021-08-21,37119,,0,114,,,0.0,6459657,0,24692,131805,0,0
2021-08-22,31881,,0,104,,,0.0,6491538,0,24692,131909,0,0
2021-08-23,32028,,0,50,,,0.0,6523566,0,24692,131959,0,0
2021-08-24,31862,,0,41,,,0.0,6555428,0,24692,132000,0,0
2021-08-25,30773,,0,174,,,0.0,6586201,0,24692,132174,0,0
2021-08-26,35625,,0,149,,,0.0,6621826,0,24692,132323,0,0
2021-08-27,38099,,0,143,,,0.0,6659925,0,24692,132466,0,0
2021-08-28,37854,,0,100,,,0.0,6697779,0,24692,132566,0,0
2021-08-29,32146,,0,133,,,0.0,6729925,0,24692,132699,0,0
2021-08-30,32979,,0,61,,,0.0,6762904,0,24692,132760,0,0
2021-08-31,0,,0,0,,,0.0,6762904,0,24692,132760,0,0
2021-09-01,0,,0,0,,,0.0,6762904,0,24692,132760,0,0
2021-09-02,0,,0,0,,,0.0,6762904,0,24692,132760,0,0
2021-09-03,0,,0,0,,,0.0,6762904,0,24692,132760,0,0
2021-09-04,0,,0,0,,,0.0,6762904,0,24692,132760,0,0
2021-09-05,0,,0,0,,,0.0,6762904,0,24692,132760,0,0
2021-09-06,0,,0,0,,,0.0,6762904,0,24692,132760,0,0
2021-09-07,0,,0,0,,,0.0,6762904,0,24692,132760,0,0
2021-09-08,0,,0,0,,,0.0,6762904,0,24692,132760,0,0
2021-09-09,0,,0,0,,,0.0,6762904,0,24692,132760,0,0
2021-09-10,331155,,5671901,914,,,0.0,7094059,0,5696593,133674,0,0
2021-09-11,0,,0,0,,,0.0,7094059,0,5696593,133674,0,0
2021-09-12,0,,0,0,,,0.0,7094059,0,5696593,133674,0,0
2021-09-13,0,,0,0,,,0.0,7094059,0,5696593,133674,0,0
2021-09-14,162500,,121202,587,,,0.0,7256559,0,5817795,134261,0,0
2021-09-15,0,,0,0,,,0.0,7256559,0,5817795,134261,0,0
2021-09-16,56124,,61094,386,,,0.0,7312683,0,5878889,134647,0,0
2021-09-17,26326,,28140,158,,,0.0,7339009,0,5907029,134805,0,0
2021-09-18,-359,,0,0,,,0.0,7338650,0,5907029,134805,0,0
2021-09-19,62089,,51662,342,,,0.0,7400739,0,5958691,135147,0,0
2021-09-20,29007,,22993,56,,,0.0,7429746,0,5981684,135203,0,0
2021-09-21,0,,0,0,,,0.0,7429746,0,5981684,135203,0,0
2021-09-22,66797,,61873,252,,,0.0,7496543,0,6043557,135455,0,0
2021-09-23,33560,,32176,166,,,0.0,7530103,0,6075733,135621,0,0
2021-09-24,0,,0,0,,,0.0,7530103,0,6075733,135621,0,0
2021-09-25,0,,0,0,,,0.0,7530103,0,6075733,135621,0,0
2021-09-26,101130,,83402,484,,,0.0,7631233,0,6159135,136105,0,0
2021-09-27,32997,,26435,63,,,0.0,7664230,0,6185570,136168,0,0
2021-09-28,0,,0,0,,,0.0,7664230,0,6185570,136168,0,0
2021-09-29,72005,,69780,207,,,0.0,7736235,0,6255350,136375,0,0
2021-09-30,35059,,36884,150,,,0.0,7771294,0,6292234,136525,0,0
2021-10-01,35742,,31662,137,,,0.0,7807036,0,6323896,136662,0,0
2021-10-02,34589,,31863,127,,,0.0,7841625,0,6355759,136789,0,0
2021-10-03,28616,,31508,121,,,0.0,7870241,0,6387267,136910,0,0
2021-10-04,30439,,30393,43,,,0.0,7900680,0,6417660,136953,0,0
2021-10-05,34256,,35472,33,,,0.0,7934936,0,6453132,136986,0,0
2021-10-06,33049,,37937,166,,,0.0,7967985,0,6491069,137152,0,0
2021-10-07,38675,,37604,143,,,0.0,8006660,0,6528673,137295,0,0
2021-10-08,39730,,32010,122,,,0.0,8046390,0,6560683,137417,0,0
2021-10-09,34910,,32842,124,,,0.0,8081300,0,6593525,137541,0,0
2021-10-10,39413,,26093,156,,,0.0,8120713,0,6619618,137697,0,0
2021-10-11,33593,,31846,38,,,0.0,8154306,0,6651464,137735,0,0
2021-10-12,39463,,35231,28,,,0.0,8193769,0,6686695,137763,0,0
2021-10-13,37668,,37646,181,,,0.0,8231437,0,6724341,137944,0,0
2021-10-14,41446,,41288,136,,,0.0,8272883,0,6765629,138080,0,0
2021-10-15,44556,,37043,157,,,0.0,8317439,0,6802672,138237,0,0
2021-10-16,44212,,36457,142,,,0.0,8361651,0,6839129,138379,0,0
2021-10-17,42818,,40606,148,,,0.0,8404469,0,6879735,138527,0,0
2021-10-18,44696,,36704,57,,,0.0,8449165,0,6916439,138584,0,0
2021-10-19,48703,,38214,45,,,0.0,8497868,0,6954653,138629,0,0
2021-10-20,43324,,37256,223,,,0.0,8541192,0,6991909,138852,0,0
2021-10-21,48545,,36802,179,,,0.0,8589737,0,7028711,139031,0,0
2021-10-22,51484,,28875,115,,,0.0,8641221,0,7057586,139146,0,0
2021-10-23,48728,,28510,180,,,0.0,8689949,0,7086096,139326,0,0
2021-10-24,44985,,30083,135,,,0.0,8734934,0,7116179,139461,0,0
2021-10-25,38740,,25937,72,,,0.0,8773674,0,7142116,139533,0,0
2021-10-26,36100,,29975,38,,,0.0,8809774,0,7172091,139571,0,0
2021-10-27,43453,,26317,263,,,0.0,8853227,0,7198408,139834,0,0
2021-10-28,43922,,33905,207,,,0.0,8897149,0,7232313,140041,0,0
2021-10-29,39006,,29454,165,,,0.0,8936155,0,7261767,140206,0,0
2021-10-30,43081,,28866,186,,,0.0,8979236,0,7290633,140392,0,0
2021-10-31,40726,,35152,166,,,0.0,9019962,0,7325785,140558,0,0
2021-11-01,37667,,30791,74,,,0.0,9057629,0,7356576,140632,0,0
2021-11-02,39682,,33545,40,,,0.0,9097311,0,7390121,140672,0,0
2021-11-03,33546,,35965,292,,,0.0,9130857,0,7426086,140964,0,0
2021-11-04,40803,,36071,217,,,0.0,9171660,0,7462157,141181,0,0
2021-11-05,36559,,30318,214,,,0.0,9208219,0,7492475,141395,0,0
2021-11-06,33697,,31497,193,,,0.0,9241916,0,7523972,141588,0,0
2021-11-07,30150,,36976,155,,,0.0,9272066,0,7560948,141743,0,0
2021-11-08,29843,,33251,62,,,0.0,9301909,0,7594199,141805,0,0
2021-11-09,31982,,35791,57,,,0.0,9333891,0,7629990,141862,0,0
2021-11-10,32785,,35542,262,,,0.0,9366676,0,7665532,142124,0,0
2021-11-11,39325,,34490,214,,,0.0,9406001,0,7700022,142338,0,0
2021-11-12,42401,,29290,195,,,0.0,9448402,0,7729312,142533,0,0
2021-11-13,38900,,29313,145,,,0.0,9487302,0,7758625,142678,0,0
2021-11-14,37669,,33953,157,,,0.0,9524971,0,7792578,142835,0,0
2021-11-15,36128,,32622,63,,,0.0,9561099,0,7825200,142898,0,0
2021-11-16,39270,,38678,47,,,0.0,9600369,0,7863878,142945,0,0
2021-11-17,36821,,39540,214,,,0.0,9637190,0,7903418,143159,0,0
2021-11-18,37868,,40569,201,,,0.0,9675058,0,7943987,143360,0,0
2021-11-19,46858,,33894,199,,,0.0,9721916,0,7977881,143559,0,0
2021-11-21,84118,,72585,307,,,0.0,9806034,0,8050466,143866,0,0
