date,today_confirm,today_suspect,today_heal,today_dead,today_severe,today_storeConfirm,today_input,total_confirm,total_suspect,total_heal,total_dead,total_severe,total_input
2020-02-08,14,0.0,0,0,,,,14,0,0,0,0,0
2020-02-13,1,0.0,0,0,,,0.0,15,0,0,0,0,0
2020-02-21,19,0.0,0,0,,,0.0,34,0,0,0,0,0
2020-02-22,19,0.0,0,0,,,0.0,53,0,0,0,0,0
2020-02-24,0,0.0,0,0,,,0.0,53,0,0,0,0,0
2020-02-25,4,0.0,0,0,,,0.0,57,0,0,0,0,0
2020-02-26,3,0.0,0,0,,,0.0,60,0,0,0,0,0
2020-02-27,0,,0,0,,,0.0,60,0,0,0,0,0
2020-02-28,3,0.0,1,0,,,0.0,63,0,1,0,0,0
2020-02-29,0,0.0,0,1,,,0.0,63,0,1,1,0,0
2020-03-01,26,0.0,0,1,,,0.0,89,0,1,2,0,0
2020-03-02,7,0.0,0,4,,,0.0,96,0,1,6,0,0
2020-03-03,26,0.0,0,3,0.0,,0.0,122,0,1,9,0,0
2020-03-04,41,0.0,0,3,0.0,,0.0,163,0,1,12,0,0
2020-03-05,69,0.0,0,2,0.0,,0.0,232,0,1,14,0,0
2020-03-06,92,0.0,9,0,0.0,,0.0,324,0,10,14,0,0
2020-03-07,121,0.0,0,5,0.0,,0.0,445,0,10,19,0,0
2020-03-08,102,0.0,0,2,0.0,,0.0,547,0,10,21,0,0
2020-03-09,170,0.0,0,5,0.0,,0.0,717,0,10,26,0,0
2020-03-10,287,0.0,0,5,0.0,,0.0,1004,0,10,31,0,0
2020-03-11,308,0.0,0,7,0.0,,0.0,1312,0,10,38,0,0
2020-03-12,346,0.0,0,3,0.0,,0.0,1658,0,10,41,0,0
2020-03-13,546,0.0,0,8,0.0,,0.0,2204,0,10,49,0,0
2020-03-14,612,0.0,0,11,0.0,,0.0,2816,0,10,60,0,0
2020-03-15,958,0.0,0,9,0.0,,0.0,3774,0,10,69,0,0
2020-03-16,668,0.0,0,8,0.0,,0.0,4442,0,10,77,0,0
2020-03-17,1978,0.0,0,31,0.0,,0.0,6420,0,10,108,0,0
2020-03-18,2668,0.0,96,37,0.0,,0.0,9088,0,106,145,0,0
2020-03-19,4262,0.0,0,43,0.0,,0.0,13350,0,106,188,0,0
2020-03-20,6274,0.0,41,72,0.0,,0.0,19624,0,147,260,0,0
2020-03-21,2419,0.0,24,80,0.0,,0.0,22043,0,171,340,0,0
2020-03-22,13181,0.0,7,131,0.0,,0.0,35224,0,178,471,0,0
2020-03-23,8739,0.0,0,115,0.0,,0.0,43963,0,178,586,0,0
2020-03-24,9697,0.0,0,117,0.0,,0.0,53660,0,178,703,0,0
2020-03-25,15300,0.0,0,338,0.0,,0.0,68960,0,178,1041,0,0
2020-03-26,16880,0.0,438,255,0.0,,0.0,85840,0,616,1296,0,0
2020-03-27,14174,0.0,274,410,0.0,,0.0,100014,0,890,1706,0,0
2020-03-28,14749,0.0,205,484,0.0,,0.0,114763,0,1095,2190,0,0
2020-03-29,26154,0.0,1672,299,0.0,,0.0,140917,0,2767,2489,0,0
2020-03-30,33337,0.0,2778,464,0.0,,0.0,174254,0,5545,2953,0,0
2020-03-31,19499,0.0,1596,1137,0.0,,0.0,193753,0,7141,4090,0,0
2020-04-01,22969,0.0,1531,1047,0.0,,0.0,216722,0,8672,5137,0,0
2020-04-02,28936,0.0,639,932,0.0,,0.0,245658,0,9311,6069,0,0
2020-04-03,32910,0.0,609,1094,0.0,,0.0,278568,0,9920,7163,0,0
2020-04-04,33913,0.0,5101,1340,0.0,,0.0,312481,0,15021,8503,0,0
2020-04-05,25490,0.0,2561,1151,0.0,,0.0,337971,0,17582,9654,0,0
2020-04-06,31098,0.0,2421,1364,0.0,,0.0,369069,0,20003,11018,0,0
2020-04-07,30910,0.0,2536,1894,0.0,,0.0,399979,0,22539,12912,0,0
2020-04-08,32600,0.0,1674,1918,0.0,,0.0,432579,0,24213,14830,0,0
2020-04-09,34605,0.0,2309,1906,0.0,,0.0,467184,0,26522,16736,0,0
2020-04-10,34517,0.0,2670,2045,0.0,,0.0,501701,0,29192,18781,0,0
2020-04-11,29129,0.0,3122,1865,0.0,,0.0,530830,0,32314,20646,0,0
2020-04-12,27696,0.0,9704,1500,0.0,,0.0,558526,0,42018,22146,0,0
2020-04-13,24694,0.0,2301,1508,0.0,,0.0,583220,0,44319,23654,0,0
2020-04-14,26775,0.0,5726,2415,0.0,,0.0,609995,0,50045,26069,0,0
2020-04-15,34811,0.0,2595,4856,0.0,,0.0,644806,0,52640,30925,0,0
2020-04-16,32340,,3519,3716,,,0.0,677146,0,56159,34641,0,0
2020-04-17,32875,,4351,2517,,,0.0,710021,0,60510,37158,0,0
2020-04-18,16624,0.0,0,780,0.0,,0.0,726645,0,60510,37938,0,0
2020-04-19,38424,,10502,2649,,,0.0,765069,0,71012,40587,0,0
2020-04-20,27869,0.0,0,1931,0.0,,0.0,792938,0,71012,42518,0,0
2020-04-21,32368,,11961,2825,,,0.0,825306,0,82973,45343,0,0
2020-04-22,23717,,1077,2341,,,0.0,849023,0,84050,47684,0,0
2020-04-23,37577,0.0,1872,2559,0.0,,0.0,886600,0,85922,50243,0,0
2020-04-24,39049,,24510,1974,,,0.0,925649,0,110432,52217,0,0
2020-04-25,35247,,7730,2048,,,0.0,960896,0,118162,54265,0,0
2020-04-26,25149,,615,1112,,,0.0,986045,0,118777,55377,0,0
2020-04-27,24462,,20385,1426,,,0.0,1010507,0,139162,56803,0,0
2020-04-28,25258,,3076,2462,,,0.0,1035765,0,142238,59265,0,0
2020-04-29,28329,,879,2390,,,0.0,1064094,0,143117,61655,0,0
2020-04-30,31210,,12620,2216,,,0.0,1095304,0,155737,63871,0,0
2020-05-01,36148,,5826,1905,,,0.0,1131452,0,161563,65776,0,0
2020-05-02,29386,,12162,1672,,,0.0,1160838,0,173725,67448,0,0
2020-05-03,26464,,4538,1121,,,0.0,1187302,0,178263,68569,0,0
2020-05-04,25533,,9764,1352,,,0.0,1212835,0,188027,69921,0,0
2020-05-05,25628,,12601,2366,,,0.0,1238463,0,200628,72287,0,0
2020-05-06,24230,,5754,2504,,,0.0,1262693,0,206382,74791,0,0
2020-05-07,30157,,10868,2147,,,0.0,1292850,0,217250,76938,0,0
2020-05-08,29313,,6499,1678,,,0.0,1322163,0,223749,78616,0,0
2020-05-09,24176,,13076,1388,,,0.0,1346339,0,236825,80004,0,0
2020-05-10,21299,,19511,783,,,0.0,1367638,0,256336,80787,0,0
2020-05-11,18196,,5889,1008,,,0.0,1385834,0,262225,81795,0,0
2020-05-12,22205,,18284,1571,,,0.0,1408039,0,280509,83366,0,0
2020-05-13,22309,,29750,1831,,,0.0,1430348,0,310259,85197,0,0
2020-05-14,26397,,7729,1703,,,0.0,1456745,0,317988,86900,0,0
2020-05-15,27244,,8197,1585,,,0.0,1483989,0,326185,88485,0,0
2020-05-16,23848,,13387,1634,,,0.0,1507837,0,339572,90119,0,0
2020-05-17,19827,,6817,859,,,0.0,1527664,0,346389,90978,0,0
2020-05-18,21168,,7924,895,,,0.0,1548832,0,354313,91873,0,0
2020-05-19,21243,,8750,1628,,,0.0,1570075,0,363063,93501,0,0
2020-05-20,21456,,7749,1403,,,0.0,1591531,0,370812,94904,0,0
2020-05-21,28927,,11353,1391,,,0.0,1620458,0,382165,96295,0,0
2020-05-22,24551,,44642,1339,,,0.0,1645009,0,426807,97634,0,0
2020-05-23,21819,,20059,1049,,,0.0,1666828,0,446866,98683,0,0
2020-05-24,19626,0.0,4836,617,0.0,,0.0,1686454,0,451702,99300,0,0
2020-05-25,19772,,12968,505,,,0.0,1706226,0,464670,99805,0,0
2020-05-26,19049,,15299,774,,,0.0,1725275,0,479969,100579,0,0
2020-05-27,20528,,10161,1528,,,0.0,1745803,0,490130,102107,0,0
2020-05-28,22658,,8595,1223,,,0.0,1768461,0,498725,103330,0,0
2020-05-29,25069,,20844,1212,,,0.0,1793530,0,519569,104542,0,0
2020-05-30,23290,,15669,1015,,,0.0,1816820,0,535238,105557,0,0
2020-05-31,20350,0.0,64629,638,0.0,,0.0,1837170,0,599867,106195,0,0
2020-06-01,22153,,15549,730,,,0.0,1859323,0,615416,106925,0,0
2020-06-02,21882,,30558,1134,,,0.0,1881205,0,645974,108059,0,0
2020-06-03,20578,,42696,1083,,,0.0,1901783,0,688670,109142,0,0
2020-06-04,33604,,23582,1031,,,0.0,1935387,0,712252,110173,0,0
2020-06-05,30321,,26394,1217,,,0.0,1965708,0,738646,111390,0,0
2020-06-06,22836,,13248,706,,,0.0,1988544,0,751894,112096,0,0
2020-06-07,18905,,9814,373,,,0.0,2007449,0,761708,112469,0,0
2020-06-08,19045,,11772,586,,,0.0,2026494,0,773480,113055,0,0
2020-06-09,19055,,15382,1093,,,0.0,2045549,0,788862,114148,0,0
2020-06-10,20852,,19632,982,,,0.0,2066401,0,808494,115130,0,0
2020-06-11,23300,,7592,904,,,0.0,2089701,0,816086,116034,0,0
2020-06-12,27221,,25848,791,,,0.0,2116922,0,841934,116825,0,0
2020-06-13,25302,,12172,702,,,0.0,2142224,0,854106,117527,0,0
2020-06-14,20004,,15944,331,,,0.0,2162228,0,870050,117858,0,0
2020-06-15,8422,,7996,303,,,0.0,2170650,0,878046,118161,0,0
2020-06-16,12300,,11820,122,,,0.0,2182950,0,889866,118283,0,0
2020-06-17,25450,,13175,849,,,0.0,2208400,0,903041,119132,0,0
2020-06-18,26071,,15755,809,,,0.0,2234471,0,918796,119941,0,0
2020-06-19,29180,,12198,747,,,0.0,2263651,0,930994,120688,0,0
2020-06-20,33539,,25067,719,,,0.0,2297190,0,956061,121407,0,0
2020-06-21,33388,,16880,573,,,0.0,2330578,0,972941,121980,0,0
2020-06-22,26079,,7414,267,,,0.0,2356657,0,980355,122247,0,0
2020-06-23,31496,,22574,363,,,0.0,2388153,0,1002929,122610,0,0
2020-06-24,36015,,17452,863,,,0.0,2424168,0,1020381,123473,0,0
2020-06-25,39103,,20224,808,,,0.0,2463271,0,1040605,124281,0,0
2020-06-26,41317,,11688,2499,,,0.0,2504588,0,1052293,126780,0,0
2020-06-27,48368,,16410,860,,,0.0,2552956,0,1068703,127640,0,0
2020-06-28,43581,,12734,512,,,0.0,2596537,0,1081437,128152,0,0
2020-06-29,40540,,12019,285,,,0.0,2637077,0,1093456,128437,0,0
2020-06-30,44734,,23721,346,,,0.0,2681811,0,1117177,128783,0,0
2020-07-01,46042,,26157,1339,,,0.0,2727853,0,1143334,130122,0,0
2020-07-02,52100,,21346,676,,,0.0,2779953,0,1164680,130798,0,0
2020-07-03,57236,,26411,687,,,0.0,2837189,0,1191091,131485,0,0
2020-07-06,145739,,98473,1084,,,0.0,2982928,0,1289564,132569,0,0
2020-07-07,57905,,35383,410,,,0.0,3040833,0,1324947,132979,0,0
2020-07-08,56251,,29916,993,,,0.0,3097084,0,1354863,133972,0,0
2020-07-09,61848,,37816,890,,,0.0,3158932,0,1392679,134862,0,0
2020-07-10,61067,,33749,960,,,0.0,3219999,0,1426428,135822,0,0
2020-07-11,71787,,34067,849,,,0.0,3291786,0,1460495,136671,0,0
2020-07-12,63860,,29951,732,,,0.0,3355646,0,1490446,137403,0,0
2020-07-13,58349,,26638,379,,,0.0,3413995,0,1517084,137782,0,0
2020-07-14,65488,,32385,465,,,0.0,3479483,0,1549469,138247,0,0
2020-07-15,65594,,50726,896,,,0.0,3545077,0,1600195,139143,0,0
2020-07-16,71670,,45767,997,,,0.0,3616747,0,1645962,140140,0,0
2020-07-17,78278,,33671,978,,,0.0,3695025,0,1679633,141118,0,0
2020-07-18,74987,,61600,946,,,0.0,3770012,0,1741233,142064,0,0
2020-07-19,63259,,33986,813,,,0.0,3833271,0,1775219,142877,0,0
2020-07-20,65279,,27119,412,,,0.0,3898550,0,1802338,143289,0,0
2020-07-21,62879,,47651,545,,,0.0,3961429,0,1849989,143834,0,0
2020-07-22,67140,,36594,1119,,,0.0,4028569,0,1886583,144953,0,0
2020-07-23,72306,,56054,1230,,,0.0,4100875,0,1942637,146183,0,0
2020-07-24,69116,,36980,1150,,,0.0,4169991,0,1979617,147333,0,0
2020-07-25,78336,,48457,1157,,,0.0,4248327,0,2028074,148490,0,0
2020-07-26,67382,,33618,908,,,0.0,4315709,0,2061692,149398,0,0
2020-07-27,56130,,28437,451,,,0.0,4371839,0,2090129,149849,0,0
2020-07-28,61571,,46474,595,,,0.0,4433410,0,2136603,150444,0,0
2020-07-29,64933,,49291,1876,,,0.0,4498343,0,2185894,152320,0,0
2020-07-30,2773,,373,35,,,0.0,4501116,0,2186267,152355,0,0
2020-07-31,133869,,98698,2930,,,0.0,4634985,0,2284965,155285,0,0
2020-08-01,70904,,42607,1462,,,0.0,4705889,0,2327572,156747,0,0
2020-08-02,58429,,35331,1151,,,0.0,4764318,0,2362903,157898,0,0
2020-08-03,49329,,17314,467,,,0.0,4813647,0,2380217,158365,0,0
2020-08-04,48527,,66581,564,,,0.0,4862174,0,2446798,158929,0,0
2020-08-05,56246,,34882,1361,,,0.0,4918420,0,2481680,160290,0,0
2020-08-06,55148,,58457,1311,,,0.0,4973568,0,2540137,161601,0,0
2020-08-07,58611,,36531,1203,,,0.0,5032179,0,2576668,162804,0,0
2020-08-08,63345,,40299,1290,,,0.0,5095524,0,2616967,164094,0,0
2020-08-09,54199,,21503,976,,,0.0,5149723,0,2638470,165070,0,0
2020-08-10,49721,,26231,547,,,0.0,5199444,0,2664701,165617,0,0
2020-08-11,52002,,51233,575,,,0.0,5251446,0,2715934,166192,0,0
2020-08-12,54511,,39414,1557,,,0.0,5305957,0,2755348,167749,0,0
2020-08-13,54345,,57255,1382,,,0.0,5360302,0,2812603,169131,0,0
2020-08-14,55364,,30601,1284,,,0.0,5415666,0,2843204,170415,0,0
2020-08-15,60600,,31943,1120,,,0.0,5476266,0,2875147,171535,0,0
2020-08-16,53523,,25041,1071,,,0.0,5529789,0,2900188,172606,0,0
2020-08-17,36843,,22536,522,,,0.0,5566632,0,2922724,173128,0,0
2020-08-18,45395,,50863,588,,,0.0,5612027,0,2973587,173716,0,0
2020-08-19,43947,,37511,1358,,,0.0,5655974,0,3011098,175074,0,0
2020-08-20,44957,,51233,1263,,,0.0,5700931,0,3062331,176337,0,0
2020-08-21,45341,,33153,1087,,,0.0,5746272,0,3095484,177424,0,0
2020-08-22,50455,,31934,1776,,,0.0,5796727,0,3127418,179200,0,0
2020-08-23,44701,,20662,974,,,0.0,5841428,0,3148080,180174,0,0
2020-08-24,32718,,18983,430,,,0.0,5874146,0,3167063,180604,0,0
2020-08-25,41484,,50918,510,,,0.0,5915630,0,3217981,181114,0,0
2020-08-26,40098,,36301,1290,,,0.0,5955728,0,3254282,182404,0,0
2020-08-27,44637,,59579,1249,,,0.0,6000365,0,3313861,183653,0,0
2020-08-28,46269,,34079,1143,,,0.0,6046634,0,3347940,184796,0,0
2020-08-29,49601,,27898,1105,,,0.0,6096235,0,3375838,185901,0,0
2020-08-30,42843,,32961,954,,,0.0,6139078,0,3408799,186855,0,0
2020-08-31,34158,,16924,369,,,0.0,6173236,0,3425723,187224,0,0
2020-09-01,44767,,32836,678,,,0.0,6218003,0,3458559,187902,0,0
2020-09-02,39568,,38354,998,,,0.0,6257571,0,3496913,188900,0,0
2020-09-03,33166,,50119,1064,,,0.0,6290737,0,3547032,189964,0,0
2020-09-04,44507,,28064,1094,,,0.0,6335244,0,3575096,191058,0,0
2020-09-05,53813,,60758,1053,,,0.0,6389057,0,3635854,192111,0,0
2020-09-06,42095,,71146,707,,,0.0,6431152,0,3707000,192818,0,0
2020-09-07,29098,,18970,432,,,0.0,6460250,0,3725970,193250,0,0
2020-09-08,25325,,32659,284,,,0.0,6485575,0,3758629,193534,0,0
2020-09-09,28656,,38131,498,,,0.0,6514231,0,3796760,194032,0,0
2020-09-10,35244,,49335,1207,,,0.0,6549475,0,3846095,195239,0,0
2020-09-11,38688,,33865,1089,,,0.0,6588163,0,3879960,196328,0,0
2020-09-12,48084,,38002,1093,,,0.0,6636247,0,3917962,197421,0,0
2020-09-13,40354,,32392,707,,,0.0,6676601,0,3950354,198128,0,0
2020-09-14,31857,,24595,392,,,0.0,6708458,0,3974949,198520,0,0
2020-09-15,40831,,52877,480,,,0.0,6749289,0,4027826,199000,0,0
2020-09-16,38858,,40260,1197,,,0.0,6788147,0,4068086,200197,0,0
2020-09-17,40154,,51072,1151,,,0.0,6828301,0,4119158,201348,0,0
2020-09-18,46295,,35881,865,,,0.0,6874596,0,4155039,202213,0,0
2020-09-19,51345,,36855,958,,,0.0,6925941,0,4191894,203171,0,0
2020-09-20,41462,,31799,653,,,0.0,6967403,0,4223693,203824,0,0
2020-09-21,37365,,26447,294,,,0.0,7004768,0,4250140,204118,0,0
2020-09-22,41448,,49385,388,,,0.0,7046216,0,4299525,204506,0,0
2020-09-23,51721,,46585,965,,,0.0,7097937,0,4346110,205471,0,0
2020-09-24,41616,,52797,1122,,,0.0,7139553,0,4398907,206593,0,0
2020-09-25,45918,,38668,945,,,0.0,7185471,0,4437575,207538,0,0
2020-09-26,58713,,43144,902,,,0.0,7244184,0,4480719,208440,0,0
2020-09-27,43377,,43389,737,,,0.0,7287561,0,4524108,209177,0,0
2020-09-28,33782,,36348,276,,,0.0,7321343,0,4560456,209453,0,0
2020-09-29,40268,,49180,355,,,0.0,7361611,0,4609636,209808,0,0
2020-09-30,44535,,39047,977,,,0.0,7406146,0,4648683,210785,0,0
2020-10-01,41136,,51023,955,,,0.0,7447282,0,4699706,211740,0,0
2020-10-02,47389,,36915,920,,,0.0,7494671,0,4736621,212660,0,0
2020-10-03,54652,,40203,864,,,0.0,7549323,0,4776824,213524,0,0
2020-10-04,51523,,41685,753,,,0.0,7600846,0,4818509,214277,0,0
2020-10-05,36066,,30529,334,,,0.0,7636912,0,4849038,214611,0,0
2020-10-06,42732,,46040,421,,,0.0,7679644,0,4895078,215032,0,0
2020-10-07,43102,,40467,790,,,0.0,7722746,0,4935545,215822,0,0
2020-10-08,53478,,48285,962,,,0.0,7776224,0,4983830,216784,0,0
2020-10-09,57539,,41363,954,,,0.0,7833763,0,5025193,217738,0,0
2020-10-10,60715,,39107,910,,,0.0,7894478,0,5064300,218648,0,0
2020-10-11,51027,,25542,634,,,0.0,7945505,0,5089842,219282,0,0
2020-10-12,46493,,38320,413,,,0.0,7991998,0,5128162,219695,0,0
2020-10-13,45791,,56453,316,,,0.0,8037789,0,5184615,220011,0,0
2020-10-14,52461,,41808,862,,,0.0,8090250,0,5226423,220873,0,0
2020-10-15,59793,,52330,970,,,0.0,8150043,0,5278753,221843,0,0
2020-10-16,66272,,41386,874,,,0.0,8216315,0,5320139,222717,0,0
2020-10-17,71963,,75262,927,,,0.0,8288278,0,5395401,223644,0,0
2020-10-18,54387,,36791,638,,,0.0,8342665,0,5432192,224282,0,0
2020-10-19,45134,,25492,448,,,0.0,8387799,0,5457684,224730,0,0
2020-10-20,68854,,45584,492,,,0.0,8456653,0,5503268,225222,0,0
2020-10-21,63654,,42351,927,,,0.0,8520307,0,5545619,226149,0,0
2020-10-22,64512,,56497,1260,,,0.0,8584819,0,5602116,227409,0,0
2020-10-23,76832,,53185,972,,,0.0,8661651,0,5655301,228381,0,0
2020-10-24,85302,,42860,903,,,0.0,8746953,0,5698161,229284,0,0
2020-10-25,80979,,43450,784,,,0.0,8827932,0,5741611,230068,0,0
2020-10-26,61247,,30887,442,,,0.0,8889179,0,5772498,230510,0,0
2020-10-27,73604,,61326,535,,,0.0,8962783,0,5833824,231045,0,0
2020-10-28,75247,,44140,1039,,,0.0,9038030,0,5877964,232084,0,0
2020-10-29,82721,,55248,1046,,,0.0,9120751,0,5933212,233130,0,0
2020-10-30,92016,,50133,1047,,,0.0,9212767,0,5983345,234177,0,0
2020-10-31,103530,,41167,982,,,0.0,9316297,0,6024512,235159,0,0
2020-11-01,86293,,37926,913,,,0.0,9402590,0,6062438,236072,0,0
2020-11-02,71321,,41167,399,,,0.0,9473911,0,6103605,236471,0,0
2020-11-03,93632,,67797,526,,,0.0,9567543,0,6171402,236997,0,0
2020-11-04,124985,,64768,1644,,,0.0,9692528,0,6236170,238641,0,0
2020-11-05,108827,,55849,1188,,,0.0,9801355,0,6292019,239829,0,0
2020-11-06,118167,,48453,1124,,,0.0,9919522,0,6340472,240953,0,0
2020-11-07,139064,,50736,1277,,,0.0,10058586,0,6391208,242230,0,0
2020-11-08,124232,,50536,1027,,,0.0,10182818,0,6441744,243257,0,0
2020-11-09,105662,,41676,511,,,0.0,10288480,0,6483420,243768,0,0
2020-11-10,133476,,69190,680,,,0.0,10421956,0,6552610,244448,0,0
2020-11-11,137228,,48721,1351,,,0.0,10559184,0,6601331,245799,0,0
2020-11-12,149446,,47348,1598,,,0.0,10708630,0,6648679,247397,0,0
2020-11-13,165306,,79441,1188,,,0.0,10873936,0,6728120,248585,0,0
2020-11-14,190428,,61026,1390,,,0.0,11064364,0,6789146,249975,0,0
2020-11-15,161674,,101869,1281,,,0.0,11226038,0,6891015,251256,0,0
2020-11-16,140341,,44615,576,,,0.0,11366379,0,6935630,251832,0,0
2020-11-17,171678,,83674,819,,,0.0,11538057,0,7019304,252651,0,0
2020-11-18,157654,,68492,1604,,,0.0,11695711,0,7087796,254255,0,0
2020-11-19,178016,,79200,1999,,,0.0,11873727,0,7166996,256254,0,0
2020-11-20,196985,,76492,2079,,,0.0,12070712,0,7243488,258333,0,0
2020-11-21,204014,,72835,1950,,,0.0,12274726,0,7316323,260283,0,0
2020-11-22,175940,,87524,1507,,,0.0,12450666,0,7403847,261790,0,0
2020-11-23,137995,,48693,906,,,0.0,12588661,0,7452540,262696,0,0
2020-11-24,188513,,96400,991,,,0.0,12777174,0,7548940,263687,0,0
2020-11-25,177833,,87744,2204,,,0.0,12955007,0,7636684,265891,0,0
2020-11-26,182955,,168596,2328,,,0.0,13137962,0,7805280,268219,0,0
2020-11-27,110714,,41592,1336,,,0.0,13248676,0,7846872,269555,0,0
2020-11-28,205578,,98710,1471,,,0.0,13454254,0,7945582,271026,0,0
2020-11-29,156103,,95657,1228,,,0.0,13610357,0,8041239,272254,0,0
2020-11-30,140047,,65964,818,,,0.0,13750404,0,8107203,273072,0,0
2020-12-01,169466,,115676,1260,,,0.0,13919870,0,8222879,274332,0,0
2020-12-02,188620,,110139,2644,,,0.0,14108490,0,8333018,276976,0,0
2020-12-03,205451,,129329,2889,,,0.0,14313941,0,8462347,279865,0,0
2020-12-04,221255,,99080,2964,,,0.0,14535196,0,8561427,282829,0,0
2020-12-05,237339,,97455,2721,,,0.0,14772535,0,8658882,285550,0,0
2020-12-06,210890,,128856,2275,,,0.0,14983425,0,8787738,287825,0,0
2020-12-07,176104,,67855,1081,,,0.0,15159529,0,8855593,288906,0,0
2020-12-08,209517,,126653,1537,,,0.0,15369046,0,8982246,290443,0,0
2020-12-09,222663,,104823,2955,,,0.0,15591709,0,9087069,293398,0,0
2020-12-10,228333,,139342,3300,,,0.0,15820042,0,9226411,296698,0,0
2020-12-11,219351,,104454,2994,,,0.0,16039393,0,9330865,299692,0,0
2020-12-12,256065,,176554,3058,,,0.0,16295458,0,9507419,302750,0,0
2020-12-13,253908,,136906,2332,,,0.0,16549366,0,9644325,305082,0,0
2020-12-14,187901,,80114,1377,,,0.0,16737267,0,9724439,306459,0,0
2020-12-15,205555,,147224,1630,,,0.0,16942822,0,9871663,308089,0,0
2020-12-16,200957,,136190,2979,,,0.0,17143779,0,10007853,311068,0,0
2020-12-17,248839,,162882,3509,,,0.0,17392618,0,10170735,314577,0,0
2020-12-18,234152,,120322,3351,,,0.0,17626770,0,10291057,317928,0,0
2020-12-19,261583,,103229,2917,,,0.0,17888353,0,10394286,320845,0,0
2020-12-20,189415,,151159,2556,,,0.0,18077768,0,10545445,323401,0,0
2020-12-21,189811,,76637,1468,,,0.0,18267579,0,10622082,324869,0,0
2020-12-22,206137,,180414,1903,,,0.0,18473716,0,10802496,326772,0,0
2020-12-23,210912,,142601,4052,,,0.0,18684628,0,10945097,330824,0,0
2020-12-24,232524,,156769,3394,,,0.0,18917152,0,11101866,334218,0,0
2020-12-25,194174,,117257,2848,,,0.0,19111326,0,11219123,337066,0,0
2020-12-26,98840,,38588,1197,,,0.0,19210166,0,11257711,338263,0,0
2020-12-27,223681,,152790,1658,,,0.0,19433847,0,11410501,339921,0,0
2020-12-28,140000,,85374,1217,,,0.0,19573847,0,11495875,341138,0,0
2020-12-29,207777,,200852,2044,,,0.0,19781624,0,11696727,343182,0,0
2020-12-30,196080,,147745,3397,,,0.0,19977704,0,11844472,346579,0,0
2020-12-31,239287,,154322,4199,,,0.0,20216991,0,11998794,350778,0,0
2021-01-01,228663,,127012,3437,,,0.0,20445654,0,12125806,354215,0,0
2021-01-02,171692,,50035,2230,,,0.0,20617346,0,12175841,356445,0,0
2021-01-03,287355,,185546,2237,,,0.0,20904701,0,12361387,358682,0,0
2021-01-04,210335,,77251,1406,,,0.0,21115036,0,12438638,360088,0,0
2021-01-05,238015,,297874,2035,,,0.0,21353051,0,12736512,362123,0,0
2021-01-06,225555,,125704,3497,,,0.0,21578606,0,12862216,365620,0,0
2021-01-07,279010,,161926,4370,,,0.0,21857616,0,13024142,369990,0,0
2021-01-08,274429,,119175,4134,,,0.0,22132045,0,13143317,374124,0,0
2021-01-09,324857,,116632,4025,,,0.0,22456902,0,13259949,378149,0,0
2021-01-10,243036,,133129,3331,,,0.0,22699938,0,13393078,381480,0,0
2021-01-11,217396,,90412,1795,,,0.0,22917334,0,13483490,383275,0,0
2021-01-12,225863,,196971,1974,,,0.0,23143197,0,13680461,385249,0,0
2021-01-13,225028,,135567,4350,,,0.0,23368225,0,13816028,389599,0,0
2021-01-14,248120,,159008,4329,,,0.0,23616345,0,13975036,393928,0,0
2021-01-15,232065,,137083,4066,,,0.0,23848410,0,14112119,397994,0,0
2021-01-16,254019,,116850,3862,,,0.0,24102429,0,14228969,401856,0,0
2021-01-17,203614,,114675,3405,,,0.0,24306043,0,14343644,405261,0,0
2021-01-18,176007,,84707,1941,,,0.0,24482050,0,14428351,407202,0,0
2021-01-19,144326,,123334,1418,,,0.0,24626376,0,14551685,408620,0,0
2021-01-20,180588,,235167,2866,,,0.0,24806964,0,14786852,411486,0,0
2021-01-21,192011,,181864,4408,,,0.0,24998975,0,14968716,415894,0,0
2021-01-22,204253,,133344,4529,,,0.0,25203228,0,15102060,420423,0,0
2021-01-23,186814,,120659,3754,,,0.0,25390042,0,15222719,424177,0,0
2021-01-24,176747,,108230,3458,,,0.0,25566789,0,15330949,427635,0,0
2021-01-25,140932,,79630,1922,,,0.0,25707721,0,15410579,429557,0,0
2021-01-26,153876,,206781,1835,,,0.0,25861597,0,15617360,431392,0,0
2021-01-27,149625,,150053,4060,,,0.0,26011222,0,15767413,435452,0,0
2021-01-28,154979,,175344,4065,,,0.0,26166201,0,15942757,439517,0,0
2021-01-29,172406,,127370,4252,,,0.0,26338607,0,16070127,443769,0,0
2021-01-30,173586,,129445,3690,,,0.0,26512193,0,16199572,447459,0,0
2021-01-31,143547,,129378,2922,,,0.0,26655740,0,16328950,450381,0,0
2021-02-01,111489,,74893,1898,,,0.0,26767229,0,16403843,452279,0,0
2021-02-02,144146,,225687,1934,,,0.0,26911375,0,16629530,454213,0,0
2021-02-03,115972,,120892,3643,,,0.0,27027347,0,16750422,457856,0,0
2021-02-04,130175,,159422,4219,,,0.0,27157522,0,16909844,462075,0,0
2021-02-05,121149,,124907,5034,,,0.0,27278671,0,17034751,467109,0,0
2021-02-06,128653,,111418,3596,,,0.0,27407324,0,17146169,470705,0,0
2021-02-07,116721,,123037,2866,,,0.0,27524045,0,17269206,473571,0,0
2021-02-08,89668,,85876,1380,,,0.0,27613713,0,17355082,474951,0,0
2021-02-09,86916,,157502,1454,,,0.0,27700629,0,17512584,476405,0,0
2021-02-10,99317,,126633,3367,,,0.0,27799946,0,17639217,479772,0,0
2021-02-11,97268,,188106,3428,,,0.0,27897214,0,17827323,483200,0,0
2021-02-12,105026,,103496,3722,,,0.0,28002240,0,17930819,486922,0,0
2021-02-13,104464,,109493,5599,,,0.0,28106704,0,18040312,492521,0,0
2021-02-14,90260,,112814,3542,,,0.0,28196964,0,18153126,496063,0,0
2021-02-15,65692,,72009,1114,,,0.0,28262656,0,18225135,497177,0,0
2021-02-16,55047,,131490,1026,,,0.0,28317703,0,18356625,498203,0,0
2021-02-17,68121,,124716,1947,,,0.0,28385824,0,18481341,500150,0,0
2021-02-18,67702,,115156,2394,,,0.0,28453526,0,18596497,502544,0,0
2021-02-19,73507,,108772,2785,,,0.0,28527033,0,18705269,505329,0,0
2021-02-20,76780,,98454,2417,,,0.0,28603813,0,18803723,507746,0,0
2021-02-21,102660,,95549,2129,,,0.0,28706473,0,18899272,509875,0,0
2021-02-22,58950,,73918,1258,,,0.0,28765423,0,18973190,511133,0,0
2021-02-23,66587,,150553,1770,,,0.0,28832010,0,19123743,512903,0,0
2021-02-24,65708,,88774,2093,,,0.0,28897718,0,19212517,514996,0,0
2021-02-25,76905,,127812,3367,,,0.0,28974623,0,19340329,518363,0,0
2021-02-26,77639,,95124,2422,,,0.0,29052262,0,19435453,520785,0,0
2021-02-27,87204,,98967,2357,,,0.0,29139466,0,19534420,523142,0,0
2021-02-28,63358,,98103,1527,,,0.0,29202824,0,19632523,524669,0,0
2021-03-01,52520,,61783,1107,,,0.0,29255344,0,19694306,525776,0,0
2021-03-02,58910,,123226,1450,,,0.0,29314254,0,19817532,527226,0,0
2021-03-03,56451,,87790,1988,,,0.0,29370705,0,19905322,529214,0,0
2021-03-04,85672,,98003,2438,,,0.0,29456377,0,20003325,531652,0,0
2021-03-05,69709,,90117,1984,,,0.0,29526086,0,20093442,533636,0,0
2021-03-06,67618,,89887,1927,,,0.0,29593704,0,20183329,535563,0,0
2021-03-07,60187,,90586,1556,,,0.0,29653891,0,20273915,537119,0,0
2021-03-08,42359,,62741,719,,,0.0,29696250,0,20336656,537838,0,0
2021-03-09,48402,,112978,790,,,0.0,29744652,0,20449634,538628,0,0
2021-03-10,56854,,100044,1946,,,0.0,29801506,0,20549678,540574,0,0
2021-03-11,60618,,90592,1617,,,0.0,29862124,0,20640270,542191,0,0
2021-03-12,63778,,157028,1530,,,0.0,29925902,0,20797298,543721,0,0
2021-03-13,67521,,1233922,1823,,,0.0,29993423,0,22031220,545544,0,0
2021-03-14,50239,,77376,1061,,,0.0,30043662,0,22108596,546605,0,0
2021-03-15,37995,,60641,629,,,0.0,30081657,0,22169237,547234,0,0
2021-03-16,56929,,117314,779,,,0.0,30138586,0,22286551,548013,0,0
2021-03-17,53638,,53838,1354,,,0.0,30192224,0,22340389,549367,0,0
2021-03-18,102574,,106886,1282,,,0.0,30294798,0,22447275,550649,0,0
2021-03-19,70847,,76882,1915,,,0.0,30365645,0,22524157,552564,0,0
2021-03-20,65194,,86359,1594,,,0.0,30430839,0,22610516,554158,0,0
2021-03-21,51288,,73101,713,,,0.0,30482127,0,22683617,554871,0,0
2021-03-22,39638,,70635,443,,,0.0,30521765,0,22754252,555314,0,0
2021-03-23,55197,,91751,631,,,0.0,30576962,0,22846003,555945,0,0
2021-03-24,59572,,193582,938,,,0.0,30636534,0,23039585,556883,0,0
2021-03-25,76159,,94020,1614,,,0.0,30712693,0,23133605,558497,0,0
2021-03-26,61340,,62604,1247,,,0.0,30774033,0,23196209,559744,0,0
2021-03-27,78999,,79059,1398,,,0.0,30853032,0,23275268,561142,0,0
2021-03-28,64098,,73236,870,,,0.0,30917130,0,23348504,562012,0,0
2021-03-29,50948,,62533,551,,,0.0,30968078,0,23411037,562563,0,0
2021-03-30,65723,,98183,643,,,0.0,31033801,0,23509220,563206,0,0
2021-03-31,63353,,77576,932,,,0.0,31097154,0,23586796,564138,0,0
2021-04-01,69190,,86666,1118,,,0.0,31166344,0,23673462,565256,0,0
2021-04-02,78295,,80929,1355,,,0.0,31244639,0,23754391,566611,0,0
2021-04-03,69986,,71244,999,,,0.0,31314625,0,23825635,567610,0,0
2021-04-04,68501,,68997,903,,,0.0,31383126,0,23894632,568513,0,0
2021-04-05,37205,,52071,264,,,0.0,31420331,0,23946703,568777,0,0
2021-04-06,70232,,76815,420,,,0.0,31490563,0,24023518,569197,0,0
2021-04-07,69875,,98703,1063,,,0.0,31560438,0,24122221,570260,0,0
2021-04-08,76805,,84318,2589,,,0.0,31637243,0,24206539,572849,0,0
2021-04-09,80161,,66330,1007,,,0.0,31717404,0,24272869,573856,0,0
2021-04-10,85368,,73897,984,,,0.0,31802772,0,24346766,574840,0,0
2021-04-11,67208,,76823,753,,,0.0,31869980,0,24423589,575593,0,0
2021-04-12,48611,,56933,236,,,0.0,31918591,0,24480522,575829,0,0
2021-04-13,71552,,80334,469,,,0.0,31990143,0,24560856,576298,0,0
2021-04-14,80641,,65554,881,,,0.0,32070784,0,24626410,577179,0,0
2021-04-15,78439,,69751,913,,,0.0,32149223,0,24696161,578092,0,0
2021-04-16,74916,,74819,901,,,0.0,32224139,0,24770980,578993,0,0
2021-04-17,81773,,65207,949,,,0.0,32305912,0,24836187,579942,0,0
2021-04-18,66207,,69145,814,,,0.0,32372119,0,24905332,580756,0,0
2021-04-19,32335,,55897,305,,,0.0,32404454,0,24961229,581061,0,0
2021-04-20,70589,,82234,481,,,0.0,32475043,0,25043463,581542,0,0
2021-04-21,61427,,62072,914,,,0.0,32536470,0,25105535,582456,0,0
2021-04-22,65581,,71899,874,,,0.0,32602051,0,25177434,583330,0,0
2021-04-23,67070,,59224,896,,,0.0,32669121,0,25236658,584226,0,0
2021-04-24,66583,,59389,849,,,0.0,32735704,0,25296047,585075,0,0
2021-04-25,53949,,43827,805,,,0.0,32789653,0,25339874,585880,0,0
2021-04-26,36513,,39986,297,,,0.0,32826166,0,25379860,586177,0,0
2021-04-27,48879,,95929,434,,,0.0,32875045,0,25475789,586611,0,0
2021-04-28,52046,,46124,773,,,0.0,32927091,0,25521913,587384,0,0
2021-04-29,56604,,62834,953,,,0.0,32983695,0,25584747,588337,0,0
2021-04-30,60373,,56827,870,,,0.0,33044068,0,25641574,589207,0,0
2021-05-01,59906,,68568,848,,,0.0,33103974,0,25710142,590055,0,0
2021-05-02,42034,,67785,649,,,0.0,33146008,0,25777927,590704,0,0
2021-05-03,34433,,45873,358,,,0.0,33180441,0,25823800,591062,0,0
2021-05-04,50120,,85593,452,,,0.0,33230561,0,25909393,591514,0,0
2021-05-05,44098,,56996,895,,,0.0,33274659,0,25966389,592409,0,0
2021-05-06,51102,,69010,828,,,0.0,33325761,0,26035399,593237,0,0
2021-05-07,43431,,70012,769,,,0.0,33369192,0,26105411,594006,0,0
2021-05-08,54046,,219896,975,,,0.0,33423238,0,26325307,594981,0,0
2021-05-09,31343,,80564,607,,,0.0,33454581,0,26405871,595588,0,0
2021-05-10,22200,,33841,224,,,0.0,33476781,0,26439712,595812,0,0
2021-05-11,38527,,67715,367,,,0.0,33515308,0,26507427,596179,0,0
2021-05-12,34807,,50711,767,,,0.0,33550115,0,26558138,596946,0,0
2021-05-13,36021,,62091,839,,,0.0,33586136,0,26620229,597785,0,0
2021-05-14,41929,,46995,782,,,0.0,33628065,0,26667224,598567,0,0
2021-05-15,35948,,45597,747,,,0.0,33664013,0,26712821,599314,0,0
2021-05-16,31903,,385799,549,,,0.0,33695916,0,27098620,599863,0,0
2021-05-17,20035,,37400,284,,,0.0,33715951,0,27136020,600147,0,0
2021-05-18,33528,,66298,437,,,0.0,33749479,0,27202318,600584,0,0
2021-05-19,25466,,51009,746,,,0.0,33774945,0,27253327,601330,0,0
2021-05-20,27379,,45853,619,,,0.0,33802324,0,27299180,601949,0,0
2021-05-21,30857,,59471,667,,,0.0,33833181,0,27358651,602616,0,0
2021-05-22,29217,,40778,792,,,0.0,33862398,0,27399429,603408,0,0
2021-05-23,19935,,71813,468,,,0.0,33882333,0,27471242,603876,0,0
2021-05-24,14327,,31013,211,,,0.0,33896660,0,27502255,604087,0,0
2021-05-25,26277,,61675,329,,,0.0,33922937,0,27563930,604416,0,0
2021-05-26,25454,,42652,827,,,0.0,33948391,0,27606582,605243,0,0
2021-05-27,22816,,55686,936,,,0.0,33971207,0,27662268,606179,0,0
2021-05-28,28473,,39611,1547,,,0.0,33999680,0,27701879,607726,0,0
2021-05-29,22977,,65161,1235,,,0.0,34022657,0,27767040,608961,0,0
2021-05-30,12661,,51921,460,,,0.0,34035318,0,27818961,609421,0,0
2021-05-31,7750,,21923,123,,,0.0,34043068,0,27840884,609544,0,0
2021-06-01,70078,,22956,223,,,0.0,34113146,0,27863840,609767,0,0
2021-06-02,23592,,77078,669,,,0.0,34136738,0,27940918,610436,0,0
2021-06-03,17567,,45593,584,,,0.0,34154305,0,27986511,611020,0,0
2021-06-04,21196,,39422,610,,,0.0,34175501,0,28025933,611630,0,0
2021-06-05,16522,,29062,610,,,0.0,34192023,0,28054995,612240,0,0
2021-06-06,12351,,48496,-37,,,0.0,34204374,0,28103491,612203,0,0
2021-06-07,6408,,19246,163,,,0.0,34210782,0,28122737,612366,0,0
2021-06-08,17600,,56421,393,,,0.0,34228382,0,28179158,612759,0,0
2021-06-09,14753,,41883,325,,,0.0,34243135,0,28221041,613084,0,0
2021-06-10,21592,,33050,410,,,0.0,34264727,0,28254091,613494,0,0
2021-06-11,11056,,24303,513,,,0.0,34275783,0,28278394,614007,0,0
2021-06-12,30943,,67946,748,,,0.0,34306726,0,28346340,614755,0,0
2021-06-13,9147,,35283,200,,,0.0,34315873,0,28381623,614955,0,0
2021-06-14,5850,,19025,106,,,0.0,34321723,0,28400648,615061,0,0
2021-06-15,13516,,36333,171,,,0.0,34335239,0,28436981,615232,0,0
2021-06-16,16946,,141720,485,,,0.0,34352185,0,28578701,615717,0,0
2021-06-17,14248,,38125,442,,,0.0,34366433,0,28616826,616159,0,0
2021-06-18,11784,,24617,302,,,0.0,34378217,0,28641443,616461,0,0
2021-06-19,15052,,34486,459,,,0.0,34393269,0,28675929,616920,0,0
2021-06-20,8571,,18932,171,,,0.0,34401840,0,28694861,617091,0,0
2021-06-21,4497,,16460,83,,,0.0,34406337,0,28711321,617174,0,0
2021-06-22,13501,,56186,289,,,0.0,34419838,0,28767507,617463,0,0
2021-06-23,15148,,49938,423,,,0.0,34434986,0,28817445,617886,0,0
2021-06-24,14018,,28859,408,,,0.0,34449004,0,28846304,618294,0,0
2021-06-25,16564,,25613,400,,,0.0,34465568,0,28871917,618694,0,0
2021-06-26,17357,,25573,468,,,0.0,34482925,0,28897490,619162,0,0
2021-06-27,7209,,15416,181,,,0.0,34490134,0,28912906,619343,0,0
2021-06-28,4543,,14429,81,,,0.0,34494677,0,28927335,619424,0,0
2021-06-29,17318,,36489,183,,,0.0,34511995,0,28963824,619607,0,0
2021-06-30,15498,,43549,373,,,0.0,34527493,0,29007373,619980,0,0
2021-07-01,13352,,19315,269,,,0.0,34540845,0,29026688,620249,0,0
2021-07-02,20558,,25399,396,,,0.0,34561403,0,29052087,620645,0,0
2021-07-03,19067,,20806,527,,,0.0,34580470,0,29072893,621172,0,0
2021-07-04,7706,,14528,83,,,0.0,34588176,0,29087421,621255,0,0
2021-07-05,4201,,9395,38,,,0.0,34592377,0,29096816,621293,0,0
2021-07-06,5984,,14764,42,,,0.0,34598361,0,29111580,621335,0,0
2021-07-07,24489,,33813,228,,,0.0,34622850,0,29145393,621563,0,0
2021-07-08,24482,,23001,359,,,0.0,34647332,0,29168394,621922,0,0
2021-07-09,29564,,34914,291,,,0.0,34676896,0,29203308,622213,0,0
2021-07-10,34520,,19664,495,,,0.0,34711416,0,29222972,622708,0,0
2021-07-11,14695,,11958,113,,,0.0,34726111,0,29234930,622821,0,0
2021-07-12,7533,,9173,27,,,0.0,34733644,0,29244103,622848,0,0
2021-07-13,32760,,30246,191,,,0.0,34766404,0,29274349,623039,0,0
2021-07-14,41409,,30102,396,,,0.0,34807813,0,29304451,623435,0,0
2021-07-15,40946,,19859,421,,,0.0,34848759,0,29324310,623856,0,0
2021-07-16,38396,,17603,358,,,0.0,34887155,0,29341913,624214,0,0
2021-07-17,42701,,16618,392,,,0.0,34929856,0,29358531,624606,0,0
2021-07-18,24081,,10650,109,,,0.0,34953937,0,29369181,624715,0,0
2021-07-19,10214,,7564,31,,,0.0,34964151,0,29376745,624746,0,0
2021-07-20,54449,,29457,237,,,0.0,35018600,0,29406202,624983,0,0
2021-07-21,63119,,28969,380,,,0.0,35081719,0,29435171,625363,0,0
2021-07-22,64757,,23232,445,,,0.0,35146476,0,29458403,625808,0,0
2021-07-23,69269,,19790,379,,,0.0,35215745,0,29478193,626187,0,0
2021-07-24,67400,,19682,477,,,0.0,35283145,0,29497875,626664,0,0
2021-07-25,-98474,,9248,49,,,0.0,35184671,0,29507123,626713,0,0
2021-07-26,17736,,4794,56,,,0.0,35202407,0,29511917,626769,0,0
2021-07-27,85866,,36551,275,,,0.0,35288273,0,29548468,627044,0,0
2021-07-28,66066,,22971,310,,,0.0,35354339,0,29571439,627354,0,0
2021-07-29,136229,,32893,767,,,0.0,35490568,0,29604332,628121,0,0
2021-07-30,97746,,22559,392,,,0.0,35588314,0,29626891,628513,0,0
2021-07-31,100870,,25151,559,,,0.0,35689184,0,29652042,629072,0,0
2021-08-01,64840,,14075,243,,,0.0,35754024,0,29666117,629315,0,0
2021-08-02,14900,,7173,65,,,0.0,35768924,0,29673290,629380,0,0
2021-08-03,131121,,47468,533,,,0.0,35900045,0,29720758,629913,0,0
2021-08-04,155870,,35835,619,,,0.0,36055915,0,29756593,630532,0,0
2021-08-05,120556,,30723,767,,,0.0,36176471,0,29787316,631299,0,0
2021-08-06,128603,,18277,600,,,0.0,36305074,0,29805593,631899,0,0
2021-08-07,142049,,28879,742,,,0.0,36447123,0,29834472,632641,0,0
2021-08-08,72678,,17332,354,,,0.0,36519801,0,29851804,632995,0,0
2021-08-09,23537,,7258,121,,,0.0,36543338,0,29859062,633116,0,0
2021-08-10,237504,,64258,683,,,0.0,36780842,0,29923320,633799,0,0
2021-08-11,111409,,43001,863,,,0.0,36892251,0,29966321,634662,0,0
2021-08-12,175555,,83744,595,,,0.0,37067806,0,30050065,635257,0,0
2021-08-13,142576,,47833,1088,,,0.0,37210382,0,30097898,636345,0,0
2021-08-14,155334,,32195,825,,,0.0,37365716,0,30130093,637170,0,0
2021-08-15,70119,,14516,269,,,0.0,37435835,0,30144609,637439,0,0
2021-08-16,30883,,8967,122,,,0.0,37466718,0,30153576,637561,0,0
2021-08-17,270268,,73726,1237,,,0.0,37736986,0,30227302,638798,0,0
2021-08-18,111636,,36823,952,,,0.0,37848622,0,30264125,639750,0,0
2021-08-19,233167,,77761,1657,,,0.0,38081789,0,30341886,641407,0,0
2021-08-20,150183,,48783,1706,,,0.0,38231972,0,30390669,643113,0,0
2021-08-21,169013,,48570,1183,,,0.0,38400985,0,30439239,644296,0,0
2021-08-22,118309,,23817,544,,,0.0,38519294,0,30463056,644840,0,0
2021-08-23,25850,,9748,218,,,0.0,38545144,0,30472804,645058,0,0
2021-08-24,273126,,97426,1638,,,0.0,38818270,0,30570230,646696,0,0
2021-08-25,150655,,48414,1465,,,0.0,38968925,0,30618644,648161,0,0
2021-08-26,198308,,60134,1593,,,0.0,39167233,0,30678778,649754,0,0
2021-08-27,0,,0,0,,,0.0,39167233,0,30678778,649754,0,0
2021-08-28,186304,,54033,2305,,,0.0,39353537,0,30732811,652059,0,0
2021-08-29,0,,0,0,,,0.0,39353537,0,30732811,652059,0,0
2021-08-30,315004,,93667,2637,,,0.0,39668541,0,30826478,654696,0,0
2021-08-31,0,,0,0,,,0.0,39668541,0,30826478,654696,0,0
2021-09-01,0,,0,0,,,0.0,39668541,0,30826478,654696,0,0
2021-09-02,0,,0,0,,,0.0,39668541,0,30826478,654696,0,0
2021-09-03,0,,0,0,,,0.0,39668541,0,30826478,654696,0,0
2021-09-04,0,,0,0,,,0.0,39668541,0,30826478,654696,0,0
2021-09-05,0,,0,0,,,0.0,39668541,0,30826478,654696,0,0
2021-09-06,0,,0,0,,,0.0,39668541,0,30826478,654696,0,0
2021-09-07,0,,0,0,,,0.0,39668541,0,30826478,654696,0,0
2021-09-08,0,,0,0,,,0.0,39668541,0,30826478,654696,0,0
2021-09-09,0,,0,0,,,0.0,39668541,0,30826478,654696,0,0
2021-09-10,1731867,,841029,17922,,,0.0,41400408,0,31667507,672618,0,0
2021-09-11,0,,0,0,,,0.0,41400408,0,31667507,672618,0,0
2021-09-12,0,,0,0,,,0.0,41400408,0,31667507,672618,0,0
2021-09-13,0,,0,0,,,0.0,41400408,0,31667507,672618,0,0
2021-09-14,739695,,395398,7656,,,0.0,42140103,0,32062905,680274,0,0
2021-09-15,0,,0,0,,,0.0,42140103,0,32062905,680274,0,0
2021-09-16,339677,,208179,4749,,,0.0,42479780,0,32271084,685023,0,0
2021-09-17,154274,,76642,3463,,,0.0,42634054,0,32347726,688486,0,0
2021-09-18,7928,,0,290,,,0.0,42641982,0,32347726,688776,0,0
2021-09-19,224823,,135500,2786,,,0.0,42866805,0,32483226,691562,0,0
2021-09-20,34101,,20769,318,,,0.0,42900906,0,32503995,691880,0,0
2021-09-21,0,,0,0,,,0.0,42900906,0,32503995,691880,0,0
2021-09-22,341396,,326030,4987,,,0.0,43242302,0,32830025,696867,0,0
2021-09-23,162575,,117829,2881,,,0.0,43404877,0,32947854,699748,0,0
2021-09-24,0,,0,0,,,0.0,43404877,0,32947854,699748,0,0
2021-09-25,0,,0,0,,,0.0,43404877,0,32947854,699748,0,0
2021-09-26,320727,,214190,6310,,,0.0,43725604,0,33162044,706058,0,0
2021-09-27,25379,,24217,259,,,0.0,43750983,0,33186261,706317,0,0
2021-09-28,0,,0,0,,,0.0,43750983,0,33186261,706317,0,0
2021-09-29,303842,,334697,4905,,,0.0,44054825,0,33520958,711222,0,0
2021-09-30,144671,,113744,2731,,,0.0,44199496,0,33634702,713953,0,0
2021-10-01,114928,,86996,2894,,,0.0,44314424,0,33721698,716847,0,0
2021-10-02,128981,,94796,2137,,,0.0,44443405,0,33816494,718984,0,0
2021-10-03,47492,,101465,690,,,0.0,44490897,0,33917959,719674,0,0
2021-10-04,27540,,20188,259,,,0.0,44518437,0,33938147,719933,0,0
2021-10-05,164398,,216630,2335,,,0.0,44682835,0,34154777,722268,0,0
2021-10-06,98365,,127344,2460,,,0.0,44781200,0,34282121,724728,0,0
2021-10-07,137365,,110205,2982,,,0.0,44918565,0,34392326,727710,0,0
2021-10-08,102702,,86805,2496,,,0.0,45021267,0,34479131,730206,0,0
2021-10-09,114353,,98385,2271,,,0.0,45135620,0,34577516,732477,0,0
2021-10-10,43589,,53138,581,,,0.0,45179209,0,34630654,733058,0,0
2021-10-11,25164,,34309,517,,,0.0,45204373,0,34664963,733575,0,0
2021-10-12,108980,,132202,1036,,,0.0,45313353,0,34797165,734611,0,0
2021-10-13,117814,,200803,2978,,,0.0,45431167,0,34997968,737589,0,0
2021-10-14,116753,,109484,2189,,,0.0,45547920,0,35107452,739778,0,0
2021-10-15,91092,,97806,2115,,,0.0,45639012,0,35205258,741893,0,0
2021-10-16,99573,,98839,1987,,,0.0,45738585,0,35304097,743880,0,0
2021-10-17,35590,,48246,505,,,0.0,45774175,0,35352343,744385,0,0
2021-10-18,18357,,22252,161,,,0.0,45792532,0,35374595,744546,0,0
2021-10-19,115680,,198915,1963,,,0.0,45908212,0,35573510,746509,0,0
2021-10-20,88295,,136821,2143,,,0.0,45996507,0,35710331,748652,0,0
2021-10-21,95855,,103995,3159,,,0.0,46092362,0,35814326,751811,0,0
2021-10-22,82185,,83715,1936,,,0.0,46174547,0,35898041,753747,0,0
2021-10-23,90049,,102780,1974,,,0.0,46264596,0,36000821,755721,0,0
2021-10-24,29614,,33065,484,,,0.0,46294210,0,36033886,756205,0,0
2021-10-25,18572,,18728,157,,,0.0,46312782,0,36052614,756362,0,0
2021-10-26,104743,,218713,1487,,,0.0,46417525,0,36271327,757849,0,0
2021-10-27,80194,,103862,2083,,,0.0,46497719,0,36375189,759932,0,0
2021-10-28,99284,,101567,1924,,,0.0,46597003,0,36476756,761856,0,0
2021-10-29,88142,,89192,1928,,,0.0,46685145,0,36565948,763784,0,0
2021-10-30,86834,,80952,1938,,,0.0,46771979,0,36646900,765722,0,0
2021-10-31,27991,,45364,395,,,0.0,46799970,0,36692264,766117,0,0
2021-11-01,23968,,23049,182,,,0.0,46823938,0,36715313,766299,0,0
2021-11-02,107346,,166523,1137,,,0.0,46931284,0,36881836,767436,0,0
2021-11-03,68487,,128154,1411,,,0.0,46999771,0,37009990,768847,0,0
2021-11-04,105697,,106614,2007,,,0.0,47105468,0,37116604,770854,0,0
2021-11-05,81788,,77507,1461,,,0.0,47187256,0,37194111,772315,0,0
2021-11-06,93193,,75398,2358,,,0.0,47280449,0,37269509,774673,0,0
2021-11-07,32963,,42157,422,,,0.0,47313412,0,37311666,775095,0,0
2021-11-08,23165,,21283,123,,,0.0,47336577,0,37332949,775218,0,0
2021-11-09,117373,,163415,1093,,,0.0,47453950,0,37496364,776311,0,0
2021-11-10,82586,,108176,2005,,,0.0,47536536,0,37604540,778316,0,0
2021-11-11,111209,,97225,1920,,,0.0,47647745,0,37701765,780236,0,0
2021-11-12,45771,,27724,539,,,0.0,47693516,0,37729489,780775,0,0
2021-11-13,141294,,116816,2158,,,0.0,47834810,0,37846305,782933,0,0
2021-11-14,57187,,51030,506,,,0.0,47891997,0,37897335,783439,0,0
2021-11-15,24193,,20966,126,,,0.0,47916190,0,37918301,783565,0,0
2021-11-16,156708,,132208,1214,,,0.0,48072898,0,38050509,784779,0,0
2021-11-17,88479,,89419,1489,,,0.0,48161377,0,38139928,786268,0,0
2021-11-18,126548,,120856,1716,,,0.0,48287925,0,38260784,787984,0,0
2021-11-19,110530,,69289,1171,,,0.0,48398455,0,38330073,789155,0,0
2021-11-21,159774,,107779,4384,,,0.0,48558229,0,38437852,793539,0,0
